시리얼,온도 평균(℃),습도 평균(%),총 결측 수,총 행 수,결측률 (%)
OC3CL200011,7723,8023,15746,9844,79.97765136123527
V02Q1940856,4932,5226,10158,8246,61.593499878729084
V02Q1940423,5746,6040,11786,9752,60.42863002461034
V02Q1940700,5727,6027,11754,9764,60.19049569848423
V02Q1940703,5693,5993,11686,9713,60.15649130031916
OC3CL200017,5781,6075,11856,9861,60.115606936416185
V02Q1940946,5741,6047,11788,9811,60.07542554275813
V02Q1940059,5733,6027,11760,9791,60.05515269124706
OC3CL210100,4991,5294,10285,8578,59.94987176498018
V02Q1940568,5662,5962,11624,9749,59.6163709098369
V02Q1940954,5705,5996,11701,9857,59.353758750126815
V02Q1940505,5231,5231,10462,8966,58.34262770466205
OC3CL200126,5251,5545,10796,9729,55.483605714873065
V02Q1940587,4462,4765,9227,8467,54.48801228298098
V02Q1940055,5124,5418,10542,9763,53.989552391682885
V02Q1940093,5031,5325,10356,9783,52.92854952468568
V02Q1940384,4972,5266,10238,9781,52.33616194663122
V02Q1940728,4949,5243,10192,9757,52.22916880188583
V02Q1940589,4911,5214,10125,9723,52.06726319037334
V02Q1940444,4932,5229,10161,9764,52.03297828758705
OT3CL180000,1,1,2,2,50.0
V02Q1940129,4592,4763,9355,9838,47.54523277088839
V02Q1940824,3526,3820,7346,8839,41.55447448806426
V02Q1940437,3588,3885,7473,9770,38.244626407369495
V02Q1940352,2991,3051,6042,9819,30.766880537732966
V02Q1940756,2335,2377,4712,9743,24.181463614903006
V02Q1940530,846,846,1692,3713,22.78481012658228
V02Q1940421,1482,1653,3135,9752,16.073625922887615
OC3CL200062,739,739,1478,9770,7.563971340839304
OC3CL200225,303,0,303,6024,2.5149402390438245
OC3CL200245,174,174,348,9806,1.7744238221497042
V02Q1940816,294,0,294,8595,1.7102966841186735
V02Q1940226,303,0,303,9657,1.5688101894998447
V02Q1940150,297,0,297,9575,1.5509138381201044
V02Q1940579,303,0,303,9776,1.5497135842880525
V02Q1940519,300,0,300,9701,1.5462323471807031
V02Q1940654,297,0,297,9620,1.5436590436590438
V02Q1940079,291,0,291,9432,1.5426208651399491
OC3CL200040,297,0,297,9644,1.5398175031107424
V02Q1940130,297,0,297,9719,1.5279349727338203
V02Q1940473,294,0,294,9666,1.5207945375543142
V02Q1940239,297,0,297,9807,1.5142245334964821
V02Q1940068,297,0,297,9838,1.509453140882293
V02Q1940574,58,58,116,7428,0.78082929456112
V02Q1940951,58,58,116,8900,0.651685393258427
V02Q1940511,15,15,30,4344,0.3453038674033149
V02Q1940851,21,21,42,9831,0.21361000915471468
V02Q1940688,6,6,12,5768,0.10402219140083217
V02Q1940553,6,6,12,8353,0.07183048006704178
V02Q1940357,1,1,2,3783,0.026434047052603753
V02Q1940873,2,2,4,8132,0.024594195769798325
V02Q1940942,2,2,4,8296,0.024108003857280617
V02Q1940540,2,2,4,8765,0.022818026240730177
V02Q1940672,1,1,2,8605,0.011621150493898896
V02Q1940134,1,1,2,9221,0.010844810758052272
V02Q1940541,0,0,0,9749,0.0
V02Q1940538,0,0,0,9762,0.0
V02Q1940539,0,0,0,9737,0.0
V02Q1940537,0,0,0,9609,0.0
V02Q1940544,0,0,0,9766,0.0
V02Q1940547,0,0,0,9617,0.0
V02Q1940548,0,0,0,9306,0.0
V02Q1940499,0,0,0,9649,0.0
V02Q1940542,0,0,0,9756,0.0
V02Q1940543,0,0,0,9750,0.0
V02Q1940500,0,0,0,8378,0.0
V02Q1940546,0,0,0,9748,0.0
V02Q1940536,0,0,0,9744,0.0
V02Q1940545,0,0,0,9514,0.0
V02Q1940501,0,0,0,9320,0.0
V02Q1940510,0,0,0,9661,0.0
V02Q1940533,0,0,0,9740,0.0
V02Q1940502,0,0,0,9652,0.0
V02Q1940503,0,0,0,9623,0.0
V02Q1940512,0,0,0,9676,0.0
V02Q1940513,0,0,0,9238,0.0
V02Q1940514,0,0,0,9645,0.0
V02Q1940515,0,0,0,9660,0.0
V02Q1940516,0,0,0,9288,0.0
V02Q1940517,0,0,0,9295,0.0
V02Q1940518,0,0,0,9697,0.0
V02Q1940508,0,0,0,9600,0.0
V02Q1940520,0,0,0,9563,0.0
V02Q1940521,0,0,0,9701,0.0
V02Q1940522,0,0,0,9713,0.0
V02Q1940507,0,0,0,9638,0.0
V02Q1940523,0,0,0,9690,0.0
V02Q1940506,0,0,0,9667,0.0
V02Q1940524,0,0,0,9713,0.0
V02Q1940525,0,0,0,9719,0.0
V02Q1940527,0,0,0,9642,0.0
V02Q1940528,0,0,0,8889,0.0
V02Q1940529,0,0,0,9699,0.0
V02Q1940504,0,0,0,9658,0.0
V02Q1940531,0,0,0,9727,0.0
V02Q1940532,0,0,0,9744,0.0
V02Q1940509,0,0,0,9685,0.0
V02Q1940534,0,0,0,8759,0.0
V02Q1940535,0,0,0,8907,0.0
V02Q1940526,0,0,0,9698,0.0
V02Q1940559,0,0,0,9722,0.0
V02Q1940549,0,0,0,9766,0.0
V02Q1940602,0,0,0,9667,0.0
V02Q1940588,0,0,0,9761,0.0
V02Q1940590,0,0,0,8851,0.0
V02Q1940591,0,0,0,9403,0.0
V02Q1940592,0,0,0,9746,0.0
V02Q1940593,0,0,0,9710,0.0
V02Q1940594,0,0,0,9729,0.0
V02Q1940595,0,0,0,9061,0.0
V02Q1940596,0,0,0,9752,0.0
V02Q1940597,0,0,0,9781,0.0
V02Q1940598,0,0,0,9740,0.0
V02Q1940599,0,0,0,9763,0.0
V02Q1940600,0,0,0,9683,0.0
V02Q1940601,0,0,0,9358,0.0
V02Q1940603,0,0,0,9740,0.0
V02Q1940585,0,0,0,9764,0.0
V02Q1940604,0,0,0,9745,0.0
V02Q1940605,0,0,0,9722,0.0
V02Q1940606,0,0,0,9745,0.0
V02Q1940607,0,0,0,9717,0.0
V02Q1940608,0,0,0,9739,0.0
V02Q1940609,0,0,0,9715,0.0
V02Q1940610,0,0,0,9430,0.0
V02Q1940611,0,0,0,9721,0.0
V02Q1940612,0,0,0,9708,0.0
V02Q1940613,0,0,0,9693,0.0
V02Q1940614,0,0,0,9727,0.0
V02Q1940615,0,0,0,9460,0.0
V02Q1940616,0,0,0,9702,0.0
V02Q1940586,0,0,0,9507,0.0
V02Q1940584,0,0,0,9766,0.0
V02Q1940550,0,0,0,9743,0.0
V02Q1940565,0,0,0,9710,0.0
V02Q1940551,0,0,0,9735,0.0
V02Q1940552,0,0,0,9725,0.0
V02Q1940554,0,0,0,9586,0.0
V02Q1940555,0,0,0,9693,0.0
V02Q1940556,0,0,0,9711,0.0
V02Q1940557,0,0,0,9669,0.0
V02Q1940558,0,0,0,9774,0.0
V02Q1940497,0,0,0,9013,0.0
V02Q1940560,0,0,0,9761,0.0
V02Q1940561,0,0,0,9756,0.0
V02Q1940562,0,0,0,9738,0.0
V02Q1940563,0,0,0,9725,0.0
V02Q1940564,0,0,0,9764,0.0
V02Q1940566,0,0,0,9756,0.0
V02Q1940583,0,0,0,9708,0.0
V02Q1940567,0,0,0,9765,0.0
V02Q1940569,0,0,0,9623,0.0
V02Q1940570,0,0,0,9651,0.0
V02Q1940571,0,0,0,9725,0.0
V02Q1940572,0,0,0,9740,0.0
V02Q1940573,0,0,0,9761,0.0
V02Q1940575,0,0,0,9756,0.0
V02Q1940576,0,0,0,9743,0.0
V02Q1940577,0,0,0,9573,0.0
V02Q1940578,0,0,0,9787,0.0
V02Q1940580,0,0,0,9789,0.0
V02Q1940581,0,0,0,8915,0.0
V02Q1940582,0,0,0,9318,0.0
V02Q1940498,0,0,0,9641,0.0
OC3CL200008,0,0,0,12933,0.0
V02Q1940496,0,0,0,9624,0.0
V02Q1940396,0,0,0,9742,0.0
V02Q1940402,0,0,0,9710,0.0
V02Q1940401,0,0,0,9713,0.0
V02Q1940400,0,0,0,9787,0.0
V02Q1940399,0,0,0,9800,0.0
V02Q1940398,0,0,0,8904,0.0
V02Q1940397,0,0,0,9748,0.0
V02Q1940395,0,0,0,9765,0.0
V02Q1940387,0,0,0,9626,0.0
V02Q1940394,0,0,0,9754,0.0
V02Q1940393,0,0,0,9766,0.0
V02Q1940392,0,0,0,9786,0.0
V02Q1940391,0,0,0,9764,0.0
V02Q1940390,0,0,0,9750,0.0
V02Q1940389,0,0,0,9785,0.0
V02Q1940403,0,0,0,9768,0.0
V02Q1940404,0,0,0,9754,0.0
V02Q1940405,0,0,0,9776,0.0
V02Q1940406,0,0,0,9749,0.0
V02Q1940407,0,0,0,9726,0.0
V02Q1940408,0,0,0,9749,0.0
V02Q1940409,0,0,0,9751,0.0
V02Q1940410,0,0,0,9771,0.0
V02Q1940411,0,0,0,9788,0.0
V02Q1940412,0,0,0,9744,0.0
V02Q1940413,0,0,0,9749,0.0
V02Q1940414,0,0,0,9661,0.0
V02Q1940415,0,0,0,9756,0.0
V02Q1940416,0,0,0,9734,0.0
V02Q1940417,0,0,0,9811,0.0
V02Q1940418,0,0,0,9796,0.0
V02Q1940419,0,0,0,9764,0.0
V02Q1940388,0,0,0,9670,0.0
V02Q1940386,0,0,0,9789,0.0
V02Q1940422,0,0,0,9770,0.0
V02Q1940358,0,0,0,9823,0.0
V02Q1940364,0,0,0,9763,0.0
V02Q1940363,0,0,0,9810,0.0
V02Q1940362,0,0,0,9833,0.0
V02Q1940361,0,0,0,9811,0.0
V02Q1940360,0,0,0,9816,0.0
V02Q1940359,0,0,0,9854,0.0
V02Q1940356,0,0,0,9846,0.0
V02Q1940385,0,0,0,9775,0.0
V02Q1940355,0,0,0,9804,0.0
V02Q1940354,0,0,0,9809,0.0
V02Q1940353,0,0,0,9808,0.0
V02Q1940351,0,0,0,9808,0.0
V02Q1940350,0,0,0,9809,0.0
V02Q1940349,0,0,0,9787,0.0
V02Q1940367,0,0,0,9778,0.0
V02Q1940368,0,0,0,9792,0.0
V02Q1940369,0,0,0,8490,0.0
V02Q1940370,0,0,0,9817,0.0
V02Q1940371,0,0,0,9611,0.0
V02Q1940372,0,0,0,9613,0.0
V02Q1940373,0,0,0,9803,0.0
V02Q1940374,0,0,0,7589,0.0
V02Q1940375,0,0,0,9704,0.0
V02Q1940376,0,0,0,9792,0.0
V02Q1940377,0,0,0,9805,0.0
V02Q1940378,0,0,0,9328,0.0
V02Q1940379,0,0,0,9817,0.0
V02Q1940380,0,0,0,9785,0.0
V02Q1940381,0,0,0,9694,0.0
V02Q1940382,0,0,0,9800,0.0
V02Q1940383,0,0,0,9788,0.0
V02Q1940420,0,0,0,9766,0.0
V02Q1940424,0,0,0,9616,0.0
V02Q1940495,0,0,0,9631,0.0
V02Q1940470,0,0,0,9664,0.0
V02Q1940477,0,0,0,9193,0.0
V02Q1940476,0,0,0,9590,0.0
V02Q1940475,0,0,0,9669,0.0
V02Q1940474,0,0,0,9686,0.0
V02Q1940472,0,0,0,9707,0.0
V02Q1940471,0,0,0,9679,0.0
V02Q1940469,0,0,0,9602,0.0
V02Q1940461,0,0,0,9752,0.0
V02Q1940468,0,0,0,9694,0.0
V02Q1940467,0,0,0,9547,0.0
V02Q1940466,0,0,0,8370,0.0
V02Q1940465,0,0,0,9732,0.0
V02Q1940464,0,0,0,9736,0.0
V02Q1940463,0,0,0,9726,0.0
V02Q1940478,0,0,0,9705,0.0
V02Q1940479,0,0,0,9688,0.0
V02Q1940480,0,0,0,9473,0.0
V02Q1940481,0,0,0,9649,0.0
V02Q1940482,0,0,0,9658,0.0
V02Q1940483,0,0,0,9676,0.0
V02Q1940484,0,0,0,9668,0.0
V02Q1940617,0,0,0,9730,0.0
V02Q1940486,0,0,0,9676,0.0
V02Q1940487,0,0,0,9632,0.0
V02Q1940488,0,0,0,9272,0.0
V02Q1940489,0,0,0,9497,0.0
V02Q1940490,0,0,0,9638,0.0
V02Q1940491,0,0,0,9613,0.0
V02Q1940492,0,0,0,9638,0.0
V02Q1940493,0,0,0,9618,0.0
V02Q1940494,0,0,0,9629,0.0
V02Q1940462,0,0,0,9751,0.0
V02Q1940460,0,0,0,9750,0.0
V02Q1940425,0,0,0,9722,0.0
V02Q1940433,0,0,0,8909,0.0
V02Q1940440,0,0,0,9773,0.0
V02Q1940439,0,0,0,9747,0.0
V02Q1940438,0,0,0,9790,0.0
V02Q1940436,0,0,0,9719,0.0
V02Q1940435,0,0,0,9746,0.0
V02Q1940434,0,0,0,9099,0.0
V02Q1940432,0,0,0,9739,0.0
V02Q1940459,0,0,0,9725,0.0
V02Q1940431,0,0,0,9726,0.0
V02Q1940430,0,0,0,9663,0.0
V02Q1940429,0,0,0,9671,0.0
V02Q1940428,0,0,0,9599,0.0
V02Q1940427,0,0,0,9708,0.0
V02Q1940426,0,0,0,9735,0.0
V02Q1940441,0,0,0,9410,0.0
V02Q1940442,0,0,0,9581,0.0
V02Q1940443,0,0,0,9754,0.0
V02Q1940445,0,0,0,9734,0.0
V02Q1940446,0,0,0,9751,0.0
V02Q1940447,0,0,0,9747,0.0
V02Q1940448,0,0,0,9718,0.0
V02Q1940449,0,0,0,9753,0.0
V02Q1940450,0,0,0,9738,0.0
V02Q1940451,0,0,0,9736,0.0
V02Q1940452,0,0,0,9745,0.0
V02Q1940453,0,0,0,9498,0.0
V02Q1940454,0,0,0,9737,0.0
V02Q1940455,0,0,0,9741,0.0
V02Q1940456,0,0,0,9741,0.0
V02Q1940457,0,0,0,9737,0.0
V02Q1940458,0,0,0,9322,0.0
V02Q1940485,0,0,0,9622,0.0
V02Q1940629,0,0,0,9732,0.0
V02Q1940618,0,0,0,9737,0.0
V02Q1940807,0,0,0,9787,0.0
V02Q1940813,0,0,0,9114,0.0
V02Q1940812,0,0,0,9115,0.0
V02Q1940811,0,0,0,9777,0.0
V02Q1940810,0,0,0,9762,0.0
V02Q1940809,0,0,0,9764,0.0
V02Q1940808,0,0,0,9779,0.0
V02Q1940806,0,0,0,9658,0.0
V02Q1940798,0,0,0,9660,0.0
V02Q1940805,0,0,0,9774,0.0
V02Q1940804,0,0,0,9737,0.0
V02Q1940803,0,0,0,6894,0.0
V02Q1940802,0,0,0,9777,0.0
V02Q1940801,0,0,0,9472,0.0
V02Q1940800,0,0,0,9761,0.0
V02Q1940814,0,0,0,9751,0.0
V02Q1940815,0,0,0,9083,0.0
V02Q1940817,0,0,0,9755,0.0
V02Q1940818,0,0,0,9790,0.0
V02Q1940819,0,0,0,9809,0.0
V02Q1940820,0,0,0,9789,0.0
V02Q1940821,0,0,0,9805,0.0
V02Q1940822,0,0,0,9822,0.0
V02Q1940823,0,0,0,9789,0.0
V02Q1940825,0,0,0,9839,0.0
V02Q1940826,0,0,0,9762,0.0
V02Q1940827,0,0,0,9790,0.0
V02Q1940828,0,0,0,9802,0.0
V02Q1940829,0,0,0,9115,0.0
V02Q1940830,0,0,0,9070,0.0
V02Q1940831,0,0,0,5899,0.0
V02Q1940832,0,0,0,9804,0.0
V02Q1940799,0,0,0,9742,0.0
V02Q1940797,0,0,0,9764,0.0
V02Q1940619,0,0,0,9738,0.0
V02Q1940772,0,0,0,9760,0.0
V02Q1940778,0,0,0,9776,0.0
V02Q1940777,0,0,0,9771,0.0
V02Q1940776,0,0,0,9760,0.0
V02Q1940775,0,0,0,9767,0.0
V02Q1940774,0,0,0,9762,0.0
V02Q1940773,0,0,0,9776,0.0
V02Q1940771,0,0,0,9753,0.0
V02Q1940796,0,0,0,9302,0.0
V02Q1940770,0,0,0,9772,0.0
V02Q1940769,0,0,0,9757,0.0
V02Q1940768,0,0,0,9786,0.0
V02Q1940767,0,0,0,9796,0.0
V02Q1940766,0,0,0,9796,0.0
V02Q1940765,0,0,0,9789,0.0
V02Q1940779,0,0,0,9760,0.0
V02Q1940780,0,0,0,9805,0.0
V02Q1940781,0,0,0,9782,0.0
V02Q1940782,0,0,0,9125,0.0
V02Q1940783,0,0,0,9769,0.0
V02Q1940784,0,0,0,9817,0.0
V02Q1940785,0,0,0,9518,0.0
V02Q1940786,0,0,0,9813,0.0
V02Q1940787,0,0,0,9405,0.0
V02Q1940788,0,0,0,9811,0.0
V02Q1940789,0,0,0,8983,0.0
V02Q1940790,0,0,0,9791,0.0
V02Q1940791,0,0,0,9773,0.0
V02Q1940792,0,0,0,9778,0.0
V02Q1940793,0,0,0,9697,0.0
V02Q1940794,0,0,0,9772,0.0
V02Q1940795,0,0,0,9766,0.0
V02Q1940833,0,0,0,9112,0.0
V02Q1940834,0,0,0,9771,0.0
V02Q1940835,0,0,0,9760,0.0
V02Q1940881,0,0,0,5951,0.0
V02Q1940887,0,0,0,9546,0.0
V02Q1940886,0,0,0,9863,0.0
V02Q1940885,0,0,0,9870,0.0
V02Q1940884,0,0,0,9781,0.0
V02Q1940883,0,0,0,6557,0.0
V02Q1940882,0,0,0,9859,0.0
V02Q1940880,0,0,0,5794,0.0
V02Q1940836,0,0,0,9097,0.0
V02Q1940879,0,0,0,9848,0.0
V02Q1940878,0,0,0,9120,0.0
V02Q1940877,0,0,0,9809,0.0
V02Q1940876,0,0,0,9801,0.0
V02Q1940875,0,0,0,9844,0.0
V02Q1940874,0,0,0,9817,0.0
V02Q1940888,0,0,0,9876,0.0
V02Q1940889,0,0,0,9832,0.0
V02Q1940935,0,0,0,9845,0.0
V02Q1940941,0,0,0,9855,0.0
V02Q1940943,0,0,0,9810,0.0
V02Q1940944,0,0,0,9825,0.0
V02Q1940945,0,0,0,9838,0.0
V02Q1940947,0,0,0,9827,0.0
V02Q1940948,0,0,0,9480,0.0
V02Q1940949,0,0,0,9831,0.0
V02Q1940950,0,0,0,9853,0.0
V02Q1940952,0,0,0,9863,0.0
V02Q1940953,0,0,0,9886,0.0
V02Q1940955,0,0,0,9871,0.0
V02Q1941000,0,0,0,9881,0.0
V02Q1941006,0,0,0,9853,0.0
V02Q1941013,0,0,0,9869,0.0
V02Q1940872,0,0,0,9825,0.0
V02Q1940871,0,0,0,9828,0.0
V02Q1940870,0,0,0,9828,0.0
V02Q1940852,0,0,0,6819,0.0
V02Q1940837,0,0,0,9782,0.0
V02Q1940838,0,0,0,8406,0.0
V02Q1940839,0,0,0,9811,0.0
V02Q1940840,0,0,0,9787,0.0
V02Q1940841,0,0,0,9817,0.0
V02Q1940842,0,0,0,9849,0.0
V02Q1940843,0,0,0,9831,0.0
V02Q1940844,0,0,0,9826,0.0
V02Q1940845,0,0,0,9846,0.0
V02Q1940846,0,0,0,9805,0.0
V02Q1940847,0,0,0,9790,0.0
V02Q1940848,0,0,0,9281,0.0
V02Q1940849,0,0,0,9828,0.0
V02Q1940850,0,0,0,9281,0.0
V02Q1940853,0,0,0,9575,0.0
V02Q1940869,0,0,0,9819,0.0
V02Q1940854,0,0,0,9814,0.0
V02Q1940855,0,0,0,9597,0.0
V02Q1940857,0,0,0,9815,0.0
V02Q1940858,0,0,0,9838,0.0
V02Q1940859,0,0,0,9403,0.0
V02Q1940860,0,0,0,9141,0.0
V02Q1940861,0,0,0,9885,0.0
V02Q1940862,0,0,0,9892,0.0
V02Q1940863,0,0,0,9901,0.0
V02Q1940864,0,0,0,9880,0.0
V02Q1940865,0,0,0,9846,0.0
V02Q1940866,0,0,0,9883,0.0
V02Q1940867,0,0,0,9854,0.0
V02Q1940868,0,0,0,9794,0.0
V02Q1940764,0,0,0,9803,0.0
V02Q1940763,0,0,0,9772,0.0
V02Q1940762,0,0,0,9799,0.0
V02Q1940662,0,0,0,9751,0.0
V02Q1940668,0,0,0,9680,0.0
V02Q1940667,0,0,0,9687,0.0
V02Q1940666,0,0,0,9721,0.0
V02Q1940665,0,0,0,9731,0.0
V02Q1940664,0,0,0,9735,0.0
V02Q1940663,0,0,0,9767,0.0
V02Q1940661,0,0,0,9712,0.0
V02Q1940689,0,0,0,8588,0.0
V02Q1940660,0,0,0,9763,0.0
V02Q1940659,0,0,0,9474,0.0
V02Q1940658,0,0,0,9742,0.0
V02Q1940657,0,0,0,9710,0.0
V02Q1940656,0,0,0,9695,0.0
V02Q1940655,0,0,0,9689,0.0
V02Q1940669,0,0,0,9701,0.0
V02Q1940670,0,0,0,9712,0.0
V02Q1940671,0,0,0,9684,0.0
V02Q1940673,0,0,0,9678,0.0
V02Q1940674,0,0,0,9697,0.0
V02Q1940675,0,0,0,9701,0.0
V02Q1940676,0,0,0,9693,0.0
V02Q1940677,0,0,0,9155,0.0
V02Q1940678,0,0,0,3815,0.0
V02Q1940679,0,0,0,9673,0.0
V02Q1940680,0,0,0,9394,0.0
V02Q1940681,0,0,0,9761,0.0
V02Q1940682,0,0,0,9766,0.0
V02Q1940683,0,0,0,9747,0.0
V02Q1940684,0,0,0,9770,0.0
V02Q1940685,0,0,0,9748,0.0
V02Q1940686,0,0,0,9730,0.0
V02Q1940653,0,0,0,9731,0.0
V02Q1940652,0,0,0,9713,0.0
V02Q1940651,0,0,0,9680,0.0
V02Q1940634,0,0,0,9745,0.0
V02Q1940620,0,0,0,9652,0.0
V02Q1940621,0,0,0,9764,0.0
V02Q1940622,0,0,0,9760,0.0
V02Q1940623,0,0,0,9764,0.0
V02Q1940624,0,0,0,9740,0.0
V02Q1940625,0,0,0,9734,0.0
V02Q1940626,0,0,0,9768,0.0
V02Q1940627,0,0,0,9388,0.0
V02Q1940628,0,0,0,8268,0.0
V02Q1940347,0,0,0,9828,0.0
V02Q1940630,0,0,0,9247,0.0
V02Q1940631,0,0,0,9737,0.0
V02Q1940632,0,0,0,5424,0.0
V02Q1940633,0,0,0,9671,0.0
V02Q1940635,0,0,0,9725,0.0
V02Q1940650,0,0,0,9728,0.0
V02Q1940636,0,0,0,9706,0.0
V02Q1940637,0,0,0,9722,0.0
V02Q1940638,0,0,0,9749,0.0
V02Q1940639,0,0,0,8821,0.0
V02Q1940640,0,0,0,9739,0.0
V02Q1940641,0,0,0,9763,0.0
V02Q1940642,0,0,0,9752,0.0
V02Q1940643,0,0,0,9587,0.0
V02Q1940644,0,0,0,9322,0.0
V02Q1940645,0,0,0,9746,0.0
V02Q1940646,0,0,0,9735,0.0
V02Q1940647,0,0,0,9743,0.0
V02Q1940648,0,0,0,9006,0.0
V02Q1940649,0,0,0,9701,0.0
V02Q1940687,0,0,0,9742,0.0
V02Q1940690,0,0,0,9689,0.0
V02Q1940761,0,0,0,9782,0.0
V02Q1940736,0,0,0,9758,0.0
V02Q1940742,0,0,0,9677,0.0
V02Q1940741,0,0,0,9788,0.0
V02Q1940740,0,0,0,8925,0.0
V02Q1940739,0,0,0,9747,0.0
V02Q1940738,0,0,0,9773,0.0
V02Q1940737,0,0,0,9756,0.0
V02Q1940735,0,0,0,9747,0.0
V02Q1940691,0,0,0,9732,0.0
V02Q1940734,0,0,0,9719,0.0
V02Q1940733,0,0,0,9726,0.0
V02Q1940732,0,0,0,9742,0.0
V02Q1940731,0,0,0,9762,0.0
V02Q1940730,0,0,0,9743,0.0
V02Q1940729,0,0,0,9421,0.0
V02Q1940743,0,0,0,9794,0.0
V02Q1940744,0,0,0,9729,0.0
V02Q1940745,0,0,0,9556,0.0
V02Q1940746,0,0,0,9757,0.0
V02Q1940747,0,0,0,9668,0.0
V02Q1940748,0,0,0,9755,0.0
V02Q1940749,0,0,0,9773,0.0
V02Q1940750,0,0,0,9747,0.0
V02Q1940751,0,0,0,8827,0.0
V02Q1940752,0,0,0,9745,0.0
V02Q1940753,0,0,0,9772,0.0
V02Q1940754,0,0,0,9646,0.0
V02Q1940755,0,0,0,9757,0.0
V02Q1940757,0,0,0,9298,0.0
V02Q1940758,0,0,0,9332,0.0
V02Q1940759,0,0,0,9741,0.0
V02Q1940760,0,0,0,9788,0.0
V02Q1940727,0,0,0,9749,0.0
V02Q1940726,0,0,0,9756,0.0
V02Q1940725,0,0,0,9279,0.0
V02Q1940708,0,0,0,9733,0.0
V02Q1940692,0,0,0,9746,0.0
V02Q1940693,0,0,0,9720,0.0
V02Q1940694,0,0,0,9742,0.0
V02Q1940695,0,0,0,9714,0.0
V02Q1940696,0,0,0,9738,0.0
V02Q1940697,0,0,0,9740,0.0
V02Q1940698,0,0,0,9733,0.0
V02Q1940699,0,0,0,9757,0.0
V02Q1940701,0,0,0,9770,0.0
V02Q1940702,0,0,0,9666,0.0
V02Q1940704,0,0,0,9745,0.0
V02Q1940705,0,0,0,9741,0.0
V02Q1940706,0,0,0,9731,0.0
V02Q1940707,0,0,0,9723,0.0
V02Q1940709,0,0,0,9653,0.0
V02Q1940724,0,0,0,9744,0.0
V02Q1940710,0,0,0,9760,0.0
V02Q1940711,0,0,0,9737,0.0
V02Q1940712,0,0,0,9132,0.0
V02Q1940713,0,0,0,9397,0.0
V02Q1940714,0,0,0,9632,0.0
V02Q1940715,0,0,0,9497,0.0
V02Q1940716,0,0,0,9736,0.0
V02Q1940717,0,0,0,9736,0.0
V02Q1940718,0,0,0,9728,0.0
V02Q1940719,0,0,0,9558,0.0
V02Q1940720,0,0,0,9678,0.0
V02Q1940721,0,0,0,9774,0.0
V02Q1940722,0,0,0,9756,0.0
V02Q1940723,0,0,0,9664,0.0
V02Q1940348,0,0,0,9753,0.0
V02Q1940336,0,0,0,9540,0.0
V02Q1940346,0,0,0,9832,0.0
OC3CL200195,0,0,0,9855,0.0
OC3CL200201,0,0,0,9798,0.0
OC3CL200200,0,0,0,9818,0.0
OC3CL200199,0,0,0,9797,0.0
OC3CL200198,0,0,0,9825,0.0
OC3CL200197,0,0,0,9852,0.0
OC3CL200196,0,0,0,9838,0.0
OC3CL200194,0,0,0,9847,0.0
OC3CL200203,0,0,0,9786,0.0
OC3CL200193,0,0,0,9825,0.0
OC3CL200192,0,0,0,9820,0.0
OC3CL200191,0,0,0,9781,0.0
OC3CL200190,0,0,0,9789,0.0
OC3CL200189,0,0,0,9798,0.0
OC3CL200188,0,0,0,9790,0.0
OC3CL200202,0,0,0,9787,0.0
OC3CL200204,0,0,0,9809,0.0
V02Q1940044,0,0,0,9473,0.0
OC3CL200213,0,0,0,9883,0.0
OC3CL200219,0,0,0,9819,0.0
OC3CL200218,0,0,0,9776,0.0
OC3CL200217,0,0,0,9805,0.0
OC3CL200216,0,0,0,9830,0.0
OC3CL200215,0,0,0,9826,0.0
OC3CL200214,0,0,0,9847,0.0
OC3CL200212,0,0,0,9815,0.0
OC3CL200205,0,0,0,9658,0.0
OC3CL200211,0,0,0,9790,0.0
OC3CL200210,0,0,0,9795,0.0
OC3CL200209,0,0,0,9774,0.0
OC3CL200208,0,0,0,9791,0.0
OC3CL200207,0,0,0,9797,0.0
OC3CL200206,0,0,0,9785,0.0
OC3CL200187,0,0,0,9785,0.0
OC3CL200186,0,0,0,9773,0.0
OC3CL200185,0,0,0,9789,0.0
OC3CL200160,0,0,0,9747,0.0
OC3CL200166,0,0,0,9752,0.0
OC3CL200165,0,0,0,9741,0.0
OC3CL200164,0,0,0,9768,0.0
OC3CL200163,0,0,0,9745,0.0
OC3CL200162,0,0,0,9781,0.0
OC3CL200161,0,0,0,9770,0.0
OC3CL200159,0,0,0,9737,0.0
OC3CL200184,0,0,0,9772,0.0
OC3CL200158,0,0,0,9774,0.0
OC3CL200157,0,0,0,9376,0.0
OC3CL200156,0,0,0,9774,0.0
OC3CL200155,0,0,0,9830,0.0
OC3CL200154,0,0,0,9079,0.0
OC3CL200153,0,0,0,9129,0.0
OC3CL200167,0,0,0,9737,0.0
OC3CL200168,0,0,0,9748,0.0
OC3CL200169,0,0,0,9739,0.0
OC3CL200170,0,0,0,9751,0.0
OC3CL200171,0,0,0,9762,0.0
OC3CL200172,0,0,0,9802,0.0
OC3CL200173,0,0,0,9850,0.0
OC3CL200174,0,0,0,9840,0.0
OC3CL200175,0,0,0,9538,0.0
OC3CL200176,0,0,0,9832,0.0
OC3CL200177,0,0,0,9796,0.0
OC3CL200178,0,0,0,9809,0.0
OC3CL200179,0,0,0,9819,0.0
OC3CL200180,0,0,0,9808,0.0
OC3CL200181,0,0,0,9780,0.0
OC3CL200182,0,0,0,9798,0.0
OC3CL200183,0,0,0,9789,0.0
OC3CL200220,0,0,0,9819,0.0
OC3CL200221,0,0,0,8504,0.0
OC3CL200222,0,0,0,8485,0.0
OC3CL210109,0,0,0,8644,0.0
OC3CL210115,0,0,0,7330,0.0
OC3CL210114,0,0,0,8673,0.0
OC3CL210113,0,0,0,8549,0.0
OC3CL210112,0,0,0,8522,0.0
OC3CL210111,0,0,0,8658,0.0
OC3CL210110,0,0,0,8658,0.0
OC3CL210108,0,0,0,8659,0.0
OC3CL210099,0,0,0,8725,0.0
OC3CL210107,0,0,0,8679,0.0
OC3CL210106,0,0,0,8673,0.0
OC3CL210105,0,0,0,8671,0.0
OC3CL210104,0,0,0,8672,0.0
OC3CL210103,0,0,0,8663,0.0
OC3CL210102,0,0,0,8700,0.0
OC3DL220000,0,0,0,24611,0.0
OC3DL2200001,0,0,0,1512,0.0
OC3DL2200002,0,0,0,1512,0.0
OC3DL2200004,0,0,0,1512,0.0
OC3DL2200005,0,0,0,1512,0.0
OC3DL2200006,0,0,0,1512,0.0
OC3DL2200007,0,0,0,1512,0.0
OC3DL2200008,0,0,0,1512,0.0
OC3DL220001,0,0,0,11095,0.0
OC3DL2200011,0,0,0,1512,0.0
OC3DL2200012,0,0,0,1512,0.0
OC3DL2200014,0,0,0,1512,0.0
OC3DL2200015,0,0,0,1512,0.0
OC3DL2200016,0,0,0,729,0.0
OC3DL2200017,0,0,0,729,0.0
OC3DL2200018,0,0,0,738,0.0
OC3DL2200019,0,0,0,729,0.0
OC3CL210101,0,0,0,8576,0.0
OC3CL200259,0,0,0,9197,0.0
OC3CL200223,0,0,0,8422,0.0
OC3CL200233,0,0,0,9052,0.0
OC3CL200239,0,0,0,9196,0.0
OC3CL200238,0,0,0,9014,0.0
OC3CL200237,0,0,0,8976,0.0
OC3CL200236,0,0,0,9109,0.0
OC3CL200235,0,0,0,9201,0.0
OC3CL200234,0,0,0,9152,0.0
OC3CL200232,0,0,0,3195,0.0
OC3CL200258,0,0,0,2,0.0
OC3CL200231,0,0,0,9139,0.0
OC3CL200230,0,0,0,9131,0.0
OC3CL200229,0,0,0,9746,0.0
OC3CL200228,0,0,0,9786,0.0
OC3CL200227,0,0,0,9801,0.0
OC3CL200224,0,0,0,8204,0.0
OC3CL200240,0,0,0,9182,0.0
OC3CL200241,0,0,0,9172,0.0
OC3CL200242,0,0,0,9163,0.0
OC3CL200243,0,0,0,9172,0.0
OC3CL200244,0,0,0,9805,0.0
OC3CL200246,0,0,0,9151,0.0
OC3CL200247,0,0,0,9136,0.0
OC3CL200248,0,0,0,9140,0.0
OC3CL200249,0,0,0,9048,0.0
OC3CL200250,0,0,0,9061,0.0
OC3CL200251,0,0,0,9126,0.0
OC3CL200252,0,0,0,8516,0.0
OC3CL200253,0,0,0,9120,0.0
OC3CL200254,0,0,0,9159,0.0
OC3CL200255,0,0,0,8862,0.0
OC3CL200256,0,0,0,9769,0.0
OC3CL200257,0,0,0,9235,0.0
OC3CL200152,0,0,0,9103,0.0
OC3CL200151,0,0,0,9065,0.0
OC3CL200150,0,0,0,9070,0.0
OC3CL200053,0,0,0,9860,0.0
OC3CL200059,0,0,0,9762,0.0
OC3CL200058,0,0,0,9551,0.0
OC3CL200057,0,0,0,9721,0.0
OC3CL200056,0,0,0,9787,0.0
OC3CL200055,0,0,0,9463,0.0
OC3CL200054,0,0,0,9798,0.0
OC3CL200052,0,0,0,9559,0.0
OC3CL200044,0,0,0,9750,0.0
OC3CL200051,0,0,0,9776,0.0
OC3CL200050,0,0,0,9756,0.0
OC3CL200049,0,0,0,9725,0.0
OC3CL200048,0,0,0,9729,0.0
OC3CL200047,0,0,0,9755,0.0
OC3CL200046,0,0,0,9755,0.0
OC3CL200060,0,0,0,9697,0.0
OC3CL200061,0,0,0,9504,0.0
OC3CL200063,0,0,0,9759,0.0
OC3CL200064,0,0,0,9722,0.0
OC3CL200065,0,0,0,9281,0.0
OC3CL200066,0,0,0,9581,0.0
OC3CL200067,0,0,0,9704,0.0
OC3CL200068,0,0,0,9721,0.0
OC3CL200069,0,0,0,9751,0.0
OC3CL200070,0,0,0,9778,0.0
OC3CL200071,0,0,0,9774,0.0
OC3CL200072,0,0,0,9796,0.0
OC3CL200073,0,0,0,8874,0.0
OC3CL200074,0,0,0,9840,0.0
OC3CL200075,0,0,0,9808,0.0
OC3CL200076,0,0,0,9788,0.0
OC3CL200077,0,0,0,9789,0.0
OC3CL200045,0,0,0,9746,0.0
OC3CL200043,0,0,0,9751,0.0
OC3CL200079,0,0,0,9763,0.0
OC3CL200014,0,0,0,9875,0.0
OC3CL200022,0,0,0,9775,0.0
OC3CL200021,0,0,0,9787,0.0
OC3CL200020,0,0,0,9798,0.0
OC3CL200019,0,0,0,6488,0.0
OC3CL200018,0,0,0,9828,0.0
OC3CL200016,0,0,0,9844,0.0
OC3CL200013,0,0,0,9856,0.0
OC3CL200042,0,0,0,9768,0.0
OC3CL200012,0,0,0,9854,0.0
OC3CL200010,0,0,0,8418,0.0
OC3CL2000090,0,0,0,1512,0.0
OC3CL200009,0,0,0,4601,0.0
OC3CL2000089,0,0,0,1512,0.0
OC3CL2000088,0,0,0,1512,0.0
OC3CL200023,0,0,0,9794,0.0
OC3CL200025,0,0,0,8693,0.0
OC3CL200026,0,0,0,9792,0.0
OC3CL200027,0,0,0,9789,0.0
OC3CL200028,0,0,0,9775,0.0
OC3CL200029,0,0,0,9779,0.0
OC3CL200030,0,0,0,9788,0.0
OC3CL200031,0,0,0,9748,0.0
OC3CL200032,0,0,0,9778,0.0
OC3CL200033,0,0,0,9543,0.0
OC3CL200034,0,0,0,9806,0.0
OC3CL200035,0,0,0,9812,0.0
OC3CL200036,0,0,0,9789,0.0
OC3CL200037,0,0,0,9755,0.0
OC3CL200038,0,0,0,9766,0.0
OC3CL200039,0,0,0,9780,0.0
OC3CL200041,0,0,0,9776,0.0
OC3CL200078,0,0,0,9782,0.0
OC3CL200080,0,0,0,9763,0.0
OC3CL200149,0,0,0,8419,0.0
OC3CL200124,0,0,0,9085,0.0
OC3CL200131,0,0,0,9728,0.0
OC3CL200130,0,0,0,9735,0.0
OC3CL200129,0,0,0,9703,0.0
OC3CL200128,0,0,0,9721,0.0
OC3CL200127,0,0,0,9728,0.0
OC3CL200125,0,0,0,9724,0.0
OC3CL200123,0,0,0,9682,0.0
OC3CL200115,0,0,0,9766,0.0
OC3CL200122,0,0,0,9732,0.0
OC3CL200121,0,0,0,9731,0.0
OC3CL200120,0,0,0,9755,0.0
OC3CL200119,0,0,0,9756,0.0
OC3CL200118,0,0,0,9748,0.0
OC3CL200117,0,0,0,9767,0.0
OC3CL200132,0,0,0,9427,0.0
OC3CL200133,0,0,0,9799,0.0
OC3CL200134,0,0,0,9792,0.0
OC3CL200135,0,0,0,8989,0.0
OC3CL200136,0,0,0,9106,0.0
OC3CL200137,0,0,0,7853,0.0
OC3CL200138,0,0,0,9120,0.0
OC3CL200139,0,0,0,9081,0.0
OC3CL200140,0,0,0,8970,0.0
OC3CL200141,0,0,0,8616,0.0
OC3CL200142,0,0,0,8669,0.0
OC3CL200143,0,0,0,8734,0.0
OC3CL200144,0,0,0,9081,0.0
OC3CL200145,0,0,0,9069,0.0
OC3CL200146,0,0,0,9082,0.0
OC3CL200147,0,0,0,9066,0.0
OC3CL200148,0,0,0,9073,0.0
OC3CL200116,0,0,0,9711,0.0
OC3CL200114,0,0,0,9794,0.0
OC3CL200081,0,0,0,9780,0.0
OC3CL200089,0,0,0,9921,0.0
OC3CL200095,0,0,0,9770,0.0
OC3CL200094,0,0,0,9788,0.0
OC3CL200093,0,0,0,9815,0.0
OC3CL200092,0,0,0,9783,0.0
OC3CL200091,0,0,0,9727,0.0
OC3CL200090,0,0,0,9889,0.0
OC3CL200088,0,0,0,9862,0.0
OC3CL200113,0,0,0,9721,0.0
OC3CL200087,0,0,0,9905,0.0
OC3CL200086,0,0,0,9827,0.0
OC3CL200085,0,0,0,9730,0.0
OC3CL200084,0,0,0,9756,0.0
OC3CL200083,0,0,0,9738,0.0
OC3CL200082,0,0,0,9769,0.0
OC3CL200096,0,0,0,9804,0.0
OC3CL200097,0,0,0,9760,0.0
OC3CL200098,0,0,0,9763,0.0
OC3CL200099,0,0,0,9748,0.0
OC3CL200100,0,0,0,9723,0.0
OC3CL200101,0,0,0,9730,0.0
OC3CL200102,0,0,0,9730,0.0
OC3CL200103,0,0,0,9707,0.0
OC3CL200104,0,0,0,9720,0.0
OC3CL200105,0,0,0,9737,0.0
OC3CL200106,0,0,0,9737,0.0
OC3CL200107,0,0,0,9727,0.0
OC3CL200108,0,0,0,9710,0.0
OC3CL200109,0,0,0,9714,0.0
OC3CL200110,0,0,0,9737,0.0
OC3CL200111,0,0,0,9736,0.0
OC3CL200112,0,0,0,9750,0.0
V02Q1940043,0,0,0,9070,0.0
V02Q1940045,0,0,0,9721,0.0
V02Q1940345,0,0,0,9798,0.0
V02Q1940249,0,0,0,9825,0.0
V02Q1940255,0,0,0,9873,0.0
V02Q1940254,0,0,0,9846,0.0
V02Q1940253,0,0,0,9442,0.0
V02Q1940252,0,0,0,9800,0.0
V02Q1940251,0,0,0,9475,0.0
V02Q1940250,0,0,0,9826,0.0
V02Q1940248,0,0,0,9849,0.0
V02Q1940257,0,0,0,9710,0.0
V02Q1940247,0,0,0,9830,0.0
V02Q1940246,0,0,0,9815,0.0
V02Q1940245,0,0,0,9855,0.0
V02Q1940244,0,0,0,9804,0.0
V02Q1940243,0,0,0,9854,0.0
V02Q1940242,0,0,0,9810,0.0
V02Q1940256,0,0,0,9841,0.0
V02Q1940258,0,0,0,9830,0.0
V02Q1940046,0,0,0,9114,0.0
V02Q1940267,0,0,0,9494,0.0
V02Q1940273,0,0,0,9795,0.0
V02Q1940272,0,0,0,9721,0.0
V02Q1940271,0,0,0,9776,0.0
V02Q1940270,0,0,0,9803,0.0
V02Q1940269,0,0,0,9813,0.0
V02Q1940268,0,0,0,9747,0.0
V02Q1940266,0,0,0,9841,0.0
V02Q1940259,0,0,0,9819,0.0
V02Q1940265,0,0,0,9809,0.0
V02Q1940264,0,0,0,9799,0.0
V02Q1940263,0,0,0,9817,0.0
V02Q1940262,0,0,0,9826,0.0
V02Q1940261,0,0,0,9821,0.0
V02Q1940260,0,0,0,9823,0.0
V02Q1940241,0,0,0,9826,0.0
V02Q1940240,0,0,0,9838,0.0
V02Q1940238,0,0,0,9884,0.0
V02Q1940204,0,0,0,9230,0.0
V02Q1940210,0,0,0,8668,0.0
V02Q1940209,0,0,0,9726,0.0
V02Q1940208,0,0,0,9842,0.0
V02Q1940207,0,0,0,9825,0.0
V02Q1940206,0,0,0,9847,0.0
V02Q1940205,0,0,0,9760,0.0
V02Q1940203,0,0,0,9794,0.0
V02Q1940237,0,0,0,9889,0.0
V02Q1940202,0,0,0,9786,0.0
V02Q1940201,0,0,0,9606,0.0
V02Q1940200,0,0,0,5655,0.0
V02Q1940199,0,0,0,9774,0.0
V02Q1940198,0,0,0,9786,0.0
V02Q1940197,0,0,0,9802,0.0
V02Q1940215,0,0,0,9837,0.0
V02Q1940216,0,0,0,9854,0.0
V02Q1940217,0,0,0,9706,0.0
V02Q1940218,0,0,0,9837,0.0
V02Q1940219,0,0,0,9575,0.0
V02Q1940220,0,0,0,9821,0.0
V02Q1940221,0,0,0,9804,0.0
V02Q1940222,0,0,0,9806,0.0
V02Q1940223,0,0,0,9801,0.0
V02Q1940224,0,0,0,9778,0.0
V02Q1940225,0,0,0,9809,0.0
V02Q1940231,0,0,0,9814,0.0
V02Q1940232,0,0,0,9274,0.0
V02Q1940233,0,0,0,9814,0.0
V02Q1940234,0,0,0,9871,0.0
V02Q1940235,0,0,0,9843,0.0
V02Q1940236,0,0,0,9462,0.0
V02Q1940274,0,0,0,7891,0.0
V02Q1940275,0,0,0,9836,0.0
V02Q1940276,0,0,0,9845,0.0
V02Q1940321,0,0,0,9843,0.0
V02Q1940327,0,0,0,9820,0.0
V02Q1940326,0,0,0,9822,0.0
V02Q1940325,0,0,0,9821,0.0
V02Q1940324,0,0,0,9812,0.0
V02Q1940323,0,0,0,9692,0.0
V02Q1940322,0,0,0,9852,0.0
V02Q1940320,0,0,0,9807,0.0
V02Q1940312,0,0,0,9602,0.0
V02Q1940319,0,0,0,9826,0.0
V02Q1940318,0,0,0,9832,0.0
V02Q1940317,0,0,0,9804,0.0
V02Q1940316,0,0,0,9762,0.0
V02Q1940315,0,0,0,9024,0.0
V02Q1940314,0,0,0,9402,0.0
V02Q1940328,0,0,0,9811,0.0
V02Q1940329,0,0,0,9821,0.0
V02Q1940330,0,0,0,9691,0.0
V02Q1940331,0,0,0,9282,0.0
V02Q1940332,0,0,0,9802,0.0
V02Q1940333,0,0,0,9798,0.0
V02Q1940334,0,0,0,9811,0.0
V02Q1940335,0,0,0,9822,0.0
OC3CL2000087,0,0,0,1512,0.0
V02Q1940337,0,0,0,9838,0.0
V02Q1940338,0,0,0,9863,0.0
V02Q1940339,0,0,0,9757,0.0
V02Q1940340,0,0,0,9853,0.0
V02Q1940341,0,0,0,9841,0.0
V02Q1940342,0,0,0,9827,0.0
V02Q1940343,0,0,0,9825,0.0
V02Q1940344,0,0,0,9823,0.0
V02Q1940313,0,0,0,9782,0.0
V02Q1940311,0,0,0,9510,0.0
V02Q1940277,0,0,0,9845,0.0
V02Q1940286,0,0,0,9841,0.0
V02Q1940292,0,0,0,7383,0.0
V02Q1940291,0,0,0,9818,0.0
V02Q1940290,0,0,0,9854,0.0
V02Q1940289,0,0,0,9786,0.0
V02Q1940288,0,0,0,9808,0.0
V02Q1940287,0,0,0,9815,0.0
V02Q1940285,0,0,0,9834,0.0
V02Q1940310,0,0,0,9811,0.0
V02Q1940284,0,0,0,9842,0.0
V02Q1940283,0,0,0,9819,0.0
V02Q1940282,0,0,0,9794,0.0
V02Q1940281,0,0,0,9769,0.0
V02Q1940280,0,0,0,9866,0.0
V02Q1940278,0,0,0,9638,0.0
V02Q1940293,0,0,0,9808,0.0
V02Q1940294,0,0,0,8511,0.0
V02Q1940295,0,0,0,9618,0.0
V02Q1940296,0,0,0,9848,0.0
V02Q1940297,0,0,0,9602,0.0
V02Q1940298,0,0,0,8804,0.0
V02Q1940299,0,0,0,9864,0.0
V02Q1940300,0,0,0,9855,0.0
V02Q1940301,0,0,0,9450,0.0
V02Q1940302,0,0,0,9815,0.0
V02Q1940303,0,0,0,9308,0.0
V02Q1940304,0,0,0,9354,0.0
V02Q1940305,0,0,0,9854,0.0
V02Q1940306,0,0,0,9831,0.0
V02Q1940307,0,0,0,9797,0.0
V02Q1940308,0,0,0,9584,0.0
V02Q1940309,0,0,0,9802,0.0
V02Q1940196,0,0,0,8956,0.0
V02Q1940195,0,0,0,9782,0.0
V02Q1940194,0,0,0,9799,0.0
V02Q1940095,0,0,0,9821,0.0
V02Q1940101,0,0,0,9810,0.0
V02Q1940100,0,0,0,8129,0.0
V02Q1940099,0,0,0,9605,0.0
V02Q1940098,0,0,0,9610,0.0
V02Q1940097,0,0,0,9805,0.0
V02Q1940096,0,0,0,9853,0.0
V02Q1940094,0,0,0,9822,0.0
V02Q1940085,0,0,0,9853,0.0
V02Q1940092,0,0,0,9843,0.0
V02Q1940091,0,0,0,9823,0.0
V02Q1940090,0,0,0,9848,0.0
V02Q1940089,0,0,0,9852,0.0
V02Q1940088,0,0,0,9734,0.0
V02Q1940087,0,0,0,339,0.0
V02Q1940102,0,0,0,9642,0.0
V02Q1940103,0,0,0,9793,0.0
V02Q1940104,0,0,0,9804,0.0
V02Q1940105,0,0,0,9812,0.0
V02Q1940106,0,0,0,9849,0.0
V02Q1940107,0,0,0,9428,0.0
V02Q1940108,0,0,0,9896,0.0
V02Q1940109,0,0,0,9831,0.0
V02Q1940110,0,0,0,9641,0.0
V02Q1940111,0,0,0,9249,0.0
V02Q1940112,0,0,0,9831,0.0
V02Q1940113,0,0,0,9753,0.0
V02Q1940114,0,0,0,9837,0.0
V02Q1940115,0,0,0,9635,0.0
V02Q1940116,0,0,0,9341,0.0
V02Q1940117,0,0,0,9739,0.0
V02Q1940118,0,0,0,9810,0.0
V02Q1940086,0,0,0,9896,0.0
V02Q1940084,0,0,0,9854,0.0
V02Q1940120,0,0,0,9811,0.0
V02Q1940056,0,0,0,9729,0.0
V02Q1940063,0,0,0,9853,0.0
V02Q1940062,0,0,0,9827,0.0
V02Q1940061,0,0,0,9792,0.0
V02Q1940060,0,0,0,9458,0.0
V02Q1940058,0,0,0,9801,0.0
V02Q1940057,0,0,0,9140,0.0
V02Q1940054,0,0,0,9815,0.0
V02Q1940083,0,0,0,9802,0.0
V02Q1940053,0,0,0,9853,0.0
V02Q1940052,0,0,0,9809,0.0
V02Q1940051,0,0,0,9820,0.0
V02Q1940050,0,0,0,9520,0.0
V02Q1940049,0,0,0,9835,0.0
V02Q1940047,0,0,0,9843,0.0
V02Q1940064,0,0,0,9558,0.0
V02Q1940065,0,0,0,9874,0.0
V02Q1940066,0,0,0,9868,0.0
V02Q1940067,0,0,0,9817,0.0
V02Q1940069,0,0,0,9840,0.0
V02Q1940070,0,0,0,9825,0.0
V02Q1940071,0,0,0,9831,0.0
V02Q1940072,0,0,0,9832,0.0
V02Q1940073,0,0,0,9806,0.0
V02Q1940074,0,0,0,9198,0.0
V02Q1940075,0,0,0,9831,0.0
V02Q1940076,0,0,0,9795,0.0
V02Q1940077,0,0,0,9815,0.0
V02Q1940078,0,0,0,5033,0.0
V02Q1940080,0,0,0,490,0.0
V02Q1940081,0,0,0,9715,0.0
V02Q1940082,0,0,0,9803,0.0
V02Q1940119,0,0,0,9272,0.0
V02Q1940121,0,0,0,8235,0.0
V02Q1940193,0,0,0,9809,0.0
V02Q1940169,0,0,0,9839,0.0
V02Q1940175,0,0,0,9452,0.0
V02Q1940174,0,0,0,8791,0.0
V02Q1940173,0,0,0,9586,0.0
V02Q1940172,0,0,0,9831,0.0
V02Q1940171,0,0,0,9846,0.0
V02Q1940170,0,0,0,9833,0.0
V02Q1940168,0,0,0,9698,0.0
V02Q1940160,0,0,0,9796,0.0
V02Q1940167,0,0,0,9835,0.0
V02Q1940166,0,0,0,9808,0.0
V02Q1940165,0,0,0,1848,0.0
V02Q1940164,0,0,0,9773,0.0
V02Q1940163,0,0,0,9779,0.0
V02Q1940162,0,0,0,9794,0.0
V02Q1940176,0,0,0,9520,0.0
V02Q1940177,0,0,0,9788,0.0
V02Q1940178,0,0,0,9794,0.0
V02Q1940179,0,0,0,9811,0.0
V02Q1940180,0,0,0,9795,0.0
V02Q1940181,0,0,0,9764,0.0
V02Q1940182,0,0,0,9778,0.0
V02Q1940183,0,0,0,9794,0.0
V02Q1940184,0,0,0,9761,0.0
V02Q1940185,0,0,0,9777,0.0
V02Q1940186,0,0,0,8071,0.0
V02Q1940187,0,0,0,9825,0.0
V02Q1940188,0,0,0,9725,0.0
V02Q1940189,0,0,0,9840,0.0
V02Q1940190,0,0,0,9815,0.0
V02Q1940191,0,0,0,9827,0.0
V02Q1940192,0,0,0,9811,0.0
V02Q1940161,0,0,0,9766,0.0
V02Q1940159,0,0,0,9789,0.0
V02Q1940122,0,0,0,9798,0.0
V02Q1940132,0,0,0,9844,0.0
V02Q1940139,0,0,0,9791,0.0
V02Q1940138,0,0,0,9796,0.0
V02Q1940137,0,0,0,9738,0.0
V02Q1940136,0,0,0,9806,0.0
V02Q1940135,0,0,0,9800,0.0
V02Q1940133,0,0,0,9825,0.0
V02Q1940131,0,0,0,9666,0.0
V02Q1940158,0,0,0,9799,0.0
V02Q1940128,0,0,0,9885,0.0
V02Q1940127,0,0,0,9544,0.0
V02Q1940126,0,0,0,9864,0.0
V02Q1940125,0,0,0,8599,0.0
V02Q1940124,0,0,0,9816,0.0
V02Q1940123,0,0,0,9784,0.0
V02Q1940140,0,0,0,9782,0.0
V02Q1940141,0,0,0,9787,0.0
V02Q1940142,0,0,0,9794,0.0
V02Q1940143,0,0,0,9816,0.0
V02Q1940144,0,0,0,9796,0.0
V02Q1940145,0,0,0,9613,0.0
V02Q1940146,0,0,0,8974,0.0
V02Q1940147,0,0,0,9895,0.0
V02Q1940148,0,0,0,9289,0.0
V02Q1940149,0,0,0,9849,0.0
V02Q1940151,0,0,0,9187,0.0
V02Q1940152,0,0,0,9600,0.0
V02Q1940153,0,0,0,9836,0.0
V02Q1940154,0,0,0,9800,0.0
V02Q1940155,0,0,0,9792,0.0
V02Q1940156,0,0,0,9795,0.0
V02Q1940157,0,0,0,9599,0.0
V02Q1941015,0,0,0,9829,0.0
