시리얼,온도 평균(℃),습도 평균(%),총 결측 수,총 행 수,결측률 (%)
OC3CL200024,2041,2041,4082,6807,29.983840164536506
OC3CL200126,1532,1532,3064,6267,24.445508217647998
V02Q1940274,2171,2171,4342,9234,23.510937838423217
V02Q1940824,1902,1902,3804,9298,20.456012045601206
V02Q1940466,1608,1608,3216,8941,17.984565484845096
V02Q1940564,701,701,1402,9137,7.672102440626026
V02Q1940690,644,522,1166,9102,6.405185673478356
V02Q1940503,385,385,770,9115,4.223806911684037
OC3CL200210,396,203,599,8968,3.3396520963425513
V02Q1940788,400,174,574,9222,3.1121231836911734
V02Q1940530,244,129,373,7600,2.4539473684210527
OC3CL200227,129,129,258,5393,2.391989616169108
V02Q1940935,269,90,359,9294,1.9313535614374866
OC3CL200010,182,0,182,4995,1.8218218218218218
OC3CL200015,160,0,160,4994,1.6019223067681216
V02Q1940174,193,0,193,6071,1.5895239663976282
OC3CL200154,282,0,282,9105,1.5485996705107083
V02Q1940829,250,0,250,8346,1.497723460340283
OC3CL200011,134,134,268,9201,1.4563634387566569
OC3CL200153,258,0,258,9127,1.4133888462802673
OC3CL200194,259,0,259,9195,1.4083741163675911
OC3CL200198,253,0,253,9113,1.3881268517502467
V02Q1940677,227,0,227,8186,1.3865135597361349
OC3CL200113,252,0,252,9117,1.3820335636722607
OC3CL200135,250,0,250,9100,1.3736263736263736
OC3CL200156,249,0,249,9068,1.3729598588442877
OC3CL200229,248,0,248,9063,1.3682003751517158
V02Q1940878,251,0,251,9209,1.3627972635465306
V02Q1940808,251,0,251,9241,1.358078130072503
V02Q1940470,246,0,246,9063,1.3571665011585567
V02Q1940805,251,0,251,9263,1.3548526395336284
V02Q1940840,250,0,250,9232,1.3539861351819757
V02Q1940833,250,0,250,9233,1.353839488790209
V02Q1940780,250,0,250,9251,1.351205275105394
OC3CL200155,245,0,245,9079,1.3492675404780263
V02Q1940953,250,0,250,9300,1.3440860215053763
V02Q1940361,244,0,244,9116,1.338306274681878
OC3CL200200,242,0,242,9084,1.3320123293703214
OC3CL200195,240,0,240,9175,1.3079019073569482
OC3CL200159,234,0,234,8954,1.3066785794058522
OC3CL200133,238,0,238,9145,1.301257517769273
OC3CL200158,234,0,234,9039,1.294390972452705
V02Q1940836,226,0,226,8754,1.29083847384053
V02Q1940645,231,0,231,8957,1.2894942503070224
V02Q1940400,236,0,236,9161,1.2880689881017358
OC3CL200136,233,0,233,9060,1.2858719646799117
V02Q1940608,233,0,233,9061,1.2857300518706545
OC3CL200201,233,0,233,9064,1.2853045013239188
V02Q1940772,236,0,236,9189,1.2841440853194037
V02Q1940132,233,0,233,9076,1.2836051123843104
V02Q1940708,234,0,234,9138,1.2803676953381482
V02Q1940358,234,0,234,9156,1.2778505897771952
V02Q1940707,234,0,234,9159,1.2774320340648542
V02Q1940856,156,0,156,6130,1.2724306688417617
OC3CL200182,230,0,230,9038,1.2724053994246514
OC3CL200137,230,0,230,9039,1.2722646310432568
OC3CL200140,227,0,227,8945,1.2688652878703186
V02Q1940728,232,0,232,9143,1.2687301760909986
V02Q1940736,232,0,232,9167,1.2654085305988874
OC3CL200031,230,0,230,9115,1.2616566099835436
V02Q1940336,230,0,230,9116,1.2615182097411146
V02Q1940737,231,0,231,9157,1.2613301299552255
V02Q1940830,226,0,226,8975,1.2590529247910864
V02Q1940381,231,0,231,9176,1.25871839581517
OC3CL200197,230,0,230,9141,1.258068045071655
OC3CL200199,229,0,229,9107,1.2572746239156691
V02Q1940382,230,0,230,9151,1.256693257567479
V02Q1940306,229,0,229,9198,1.2448358338769296
OC3CL200138,224,0,224,9005,1.243753470294281
OC3CL200132,209,0,209,8430,1.239620403321471
V02Q1940676,226,0,226,9121,1.2388992435040018
V02Q1940289,223,0,223,9027,1.235183338872272
V02Q1940477,211,0,211,8556,1.2330528284244975
V02Q1940488,223,0,223,9079,1.2281088225575503
V02Q1940783,227,0,227,9253,1.226629201340106
OC3CL200162,220,0,220,8971,1.2261732248355812
V02Q1940806,227,0,227,9258,1.2259667314754807
V02Q1940377,225,0,225,9179,1.2256237062860877
V02Q1940569,222,0,222,9057,1.22557138125207
V02Q1940635,223,0,223,9101,1.2251400944951105
V02Q1940857,227,0,227,9267,1.2247760871911084
V02Q1940153,226,0,226,9227,1.2246667389183916
V02Q1940671,222,0,222,9066,1.2243547319655859
V02Q1940597,223,0,223,9116,1.2231241772707326
V02Q1940881,227,0,227,9285,1.2224017232094775
V02Q1940779,226,0,226,9248,1.2218858131487889
V02Q1940596,223,0,223,9129,1.2213824077116882
V02Q1940815,226,0,226,9257,1.220697850275467
V02Q1940885,227,0,227,9311,1.2189882934163894
V02Q1940816,226,0,226,9274,1.2184602113435412
V02Q1940298,224,0,224,9196,1.2179208351457156
V02Q1940820,226,0,226,9281,1.2175412132313328
V02Q1940851,226,0,226,9282,1.2174100409394528
V02Q1940550,221,0,221,9090,1.2156215621562156
OC3CL200209,216,0,216,8887,1.215258242376505
OC3CL200178,221,0,221,9099,1.2144191669414222
V02Q1940652,220,0,220,9059,1.2142620598300033
OC3CL200093,221,0,221,9102,1.2140188969457262
OC3CL200204,219,0,219,9020,1.213968957871397
OC3CL200032,220,0,220,9062,1.2138600750386228
OC3CL200161,218,0,218,8997,1.211514949427587
V02Q1940244,225,0,225,9292,1.2107188979767542
V02Q1940300,223,0,223,9216,1.2098524305555556
V02Q1940633,219,0,219,9051,1.2098110705999336
V02Q1940537,221,0,221,9142,1.2087070662874644
V02Q1940352,216,0,216,8939,1.208188835440206
V02Q1940556,220,0,220,9106,1.2079947287502746
OC3CL200157,218,0,218,9056,1.2036219081272086
V02Q1940591,218,0,218,9074,1.2012342957901698
V02Q1940682,219,0,219,9123,1.200263071358106
OC3CL200117,216,0,216,9008,1.1989342806394316
V02Q1940233,219,0,219,9143,1.1976375369134857
V02Q1940565,218,0,218,9124,1.194651468654099
V02Q1940775,220,0,220,9209,1.1944836572917799
V02Q1940542,218,0,218,9129,1.1939971519333992
V02Q1940602,217,0,217,9088,1.193882042253521
V02Q1940744,219,0,219,9213,1.1885379355258874
V02Q1940510,215,0,215,9067,1.1856181758023603
V02Q1940303,167,0,167,7057,1.1832223324358793
OC3CL200160,213,0,213,9002,1.1830704287936014
V02Q1940253,219,0,219,9256,1.1830164217804668
OC3CL200206,213,0,213,9011,1.181888802574631
V02Q1940168,214,0,214,9056,1.1815371024734982
OC3CL200164,211,0,211,8930,1.181410974244121
V02Q1940166,216,0,216,9164,1.1785246617197729
V02Q1940872,186,31,217,9218,1.1770449121284443
OC3CL200213,215,0,215,9137,1.1765349677136916
V02Q1940084,216,0,216,9187,1.1755741809078044
V02Q1940246,218,0,218,9279,1.1746955490893416
V02Q1940666,214,0,214,9124,1.1727312582200788
OC3CL200116,212,0,212,9042,1.17230701172307
V02Q1940362,214,0,214,9135,1.1713191023535852
V02Q1940726,215,0,215,9191,1.1696224567511695
V02Q1940419,213,0,213,9117,1.1681474169134585
V02Q1940150,214,0,214,9174,1.1663396555482886
V02Q1940756,166,45,211,9049,1.1658746822853354
V02Q1940251,215,0,215,9249,1.162287814898908
V02Q1940216,213,0,213,9170,1.1613958560523445
OC3CL200033,210,0,210,9043,1.1611190976445869
OC3CL200214,213,0,213,9186,1.1593729588504247
OC3CL200181,210,0,210,9057,1.159324279562769
OC3CL200055,210,0,210,9069,1.1577902745616937
V02Q1940458,211,0,211,9122,1.156544617408463
V02Q1940733,210,0,210,9086,1.155624036979969
V02Q1940317,213,0,213,9222,1.154847104749512
V02Q1940490,207,0,207,8963,1.1547472944326675
V02Q1940471,208,0,208,9045,1.1498065229408514
V02Q1940260,212,0,212,9221,1.1495499403535407
V02Q1940109,210,0,210,9143,1.1484195559444383
OC3CL200220,207,0,207,9020,1.147450110864745
V02Q1940204,163,0,163,7112,1.1459505061867266
V02Q1940258,206,0,206,8995,1.1450806003335186
V02Q1940107,211,0,211,9216,1.1447482638888888
V02Q1940534,184,0,184,8042,1.1439940313354886
V02Q1940662,208,0,208,9119,1.1404759293782212
V02Q1940741,209,0,209,9167,1.1399585469619287
V02Q1940375,209,0,209,9168,1.1398342059336823
V02Q1940379,209,0,209,9185,1.1377245508982037
V02Q1940699,208,0,208,9151,1.1364878155392852
OC3CL200203,205,0,205,9032,1.1348538529672276
V02Q1940663,206,0,206,9083,1.1339865683144335
V02Q1940155,207,0,207,9139,1.1325090272458693
V02Q1940066,207,0,207,9145,1.1317659923455439
V02Q1940180,207,0,207,9158,1.1301594234549028
OC3CL200186,202,0,202,8937,1.1301331543023385
OC3CL200036,204,0,204,9029,1.129693210765312
V02Q1940452,199,0,199,8813,1.1290139566549415
OC3CL200165,202,0,202,8948,1.1287438533750558
V02Q1940098,196,0,196,8690,1.1277330264672036
V02Q1940665,206,0,206,9142,1.1266681251367316
V02Q1940181,206,0,206,9154,1.1251911732575923
OC3CL200202,204,0,204,9070,1.1245865490628444
V02Q1940283,207,0,207,9205,1.1243889190657252
V02Q1940465,205,0,205,9125,1.1232876712328765
V02Q1940069,206,0,206,9180,1.1220043572984748
OC3CL200035,203,0,203,9052,1.12129916040654
V02Q1940514,204,0,204,9115,1.1190345584201864
V02Q1940664,204,0,204,9132,1.1169513797634691
V02Q1940201,204,0,204,9139,1.1160958529379583
OC3CL200185,200,0,200,8960,1.1160714285714286
V02Q1940105,205,0,205,9187,1.1157069772504626
V02Q1940368,176,0,176,7888,1.1156186612576064
V02Q1940130,204,0,204,9159,1.1136586963642319
OC3CL200228,202,0,202,9087,1.1114779355122701
V02Q1940659,203,0,203,9136,1.1109894921190893
V02Q1940611,200,0,200,9040,1.1061946902654867
V02Q1940050,203,0,203,9178,1.1059054260187404
V02Q1940654,199,0,199,9003,1.1051871598356104
V02Q1940222,203,0,203,9187,1.1048220311309458
OC3CL200013,202,0,202,9147,1.1041871651907729
V02Q1940536,201,0,201,9117,1.102336294833827
V02Q1940877,204,0,204,9254,1.1022260644045818
OC3CL200095,199,0,199,9046,1.0999336723413664
V02Q1940446,200,0,200,9097,1.0992634934593821
V02Q1940207,202,0,202,9195,1.0984230560087005
OC3CL200183,198,0,198,9020,1.097560975609756
OC3CL200134,200,0,200,9120,1.0964912280701753
V02Q1940455,196,0,196,8941,1.0960742646236439
V02Q1940370,201,0,201,9172,1.0957261229829918
V02Q1940445,199,0,199,9085,1.0952118877270225
V02Q1940515,200,0,200,9140,1.0940919037199124
OC3CL200205,197,0,197,9008,1.0934724689165187
V02Q1940802,202,0,202,9243,1.0927188142378017
V02Q1940888,203,0,203,9300,1.0913978494623655
V02Q1940497,199,0,199,9122,1.090769568077176
OC3CL200163,192,0,192,8805,1.090289608177172
V02Q1940823,202,0,202,9275,1.0889487870619945
V02Q1940861,202,0,202,9300,1.086021505376344
OC3CL200187,194,0,194,8948,1.084041126508717
OC3CL200177,197,0,197,9104,1.0819420035149385
V02Q1940703,198,0,198,9156,1.0812581913499346
V02Q1940472,196,0,196,9088,1.0783450704225352
V02Q1940129,197,0,197,9137,1.0780343657655687
V02Q1940613,195,0,195,9045,1.077943615257048
OC3CL200053,196,0,196,9111,1.0756228734496762
V02Q1940145,198,0,198,9211,1.0748018673325372
OC3CL200076,194,0,194,9027,1.0745541154314833
OC3CL200189,192,0,192,8934,1.0745466756212223
OC3CL200180,195,0,195,9075,1.0743801652892562
OC3CL200075,195,0,195,9082,1.0735520810394186
V02Q1940700,196,0,196,9130,1.0733844468784228
V02Q1940766,198,0,198,9229,1.0727056019070322
V02Q1940683,196,0,196,9138,1.0724447362661416
OC3CL200143,185,0,185,8641,1.0704779539405163
V02Q1940245,199,0,199,9299,1.0700075276911496
V02Q1940558,195,0,195,9115,1.0696653867251782
OC3CL200071,195,0,195,9122,1.0688445516334137
V02Q1940383,195,0,195,9127,1.0682590117234578
V02Q1940378,196,0,196,9183,1.0671893716650334
V02Q1940618,194,0,194,9095,1.0665200659703133
V02Q1940364,192,0,192,9013,1.065128148230334
V02Q1940585,194,0,194,9112,1.0645302897278315
OC3CL200169,189,0,189,8888,1.0632313231323132
V02Q1940541,194,0,194,9124,1.063130206049978
OC3CL200146,178,0,178,8377,1.0624328518562731
V02Q1940526,193,0,193,9083,1.0624243091489596
V02Q1940768,195,0,195,9203,1.059437140063023
V02Q1940110,195,0,195,9206,1.0590918965891811
V02Q1940102,193,0,193,9130,1.0569550930996714
V02Q1940746,194,0,194,9183,1.0562996841990635
V02Q1940215,193,0,193,9159,1.0536084725406705
V02Q1940203,193,0,193,9165,1.0529187124931805
OC3CL200176,193,0,193,9165,1.0529187124931805
OC3CL200074,191,0,191,9083,1.0514147308158097
V02Q1940627,191,0,191,9088,1.0508362676056338
V02Q1940067,193,0,193,9184,1.050740418118467
V02Q1940087,193,0,193,9198,1.0491411176342682
V02Q1940630,189,0,189,9008,1.0490674955595027
V02Q1940160,192,0,192,9155,1.048607318405243
V02Q1940486,182,0,182,8694,1.0466988727858293
OC3CL200144,185,0,185,8842,1.0461434064691246
V02Q1940137,191,0,191,9131,1.0458876355273246
V02Q1940331,191,0,191,9157,1.0429179862400348
V02Q1940650,189,0,189,9064,1.042586054721977
V02Q1940240,183,0,183,8777,1.0424974364817134
V02Q1940760,192,0,192,9222,1.040988939492518
V02Q1940053,189,0,189,9083,1.04040515248266
OC3CL200142,185,0,185,8892,1.0402609086819612
V02Q1940082,188,0,188,9042,1.03959301039593
V02Q1940653,188,0,188,9043,1.039478049319916
V02Q1940190,191,0,191,9194,1.038720904938003
OC3CL200051,190,0,190,9148,1.0384783559247923
OC3CL200030,188,0,188,9054,1.0382151535233046
V02Q1940642,189,0,189,9112,1.0370939420544336
OC3CL200050,188,0,188,9064,1.0370697263901147
V02Q1940388,184,0,184,8875,1.036619718309859
OC3CL200179,188,0,188,9070,1.0363836824696804
V02Q1940097,190,0,190,9179,1.0349711297526965
V02Q1940457,189,0,189,9132,1.0348226018396847
OC3CL200114,188,0,188,9084,1.0347864376926463
V02Q1940267,191,0,191,9232,1.0344454072790294
V02Q1940114,190,0,190,9196,1.0330578512396695
OC3CL200219,188,0,188,9120,1.030701754385965
OC3CL200184,185,0,185,8992,1.0286921708185053
OC3CL200094,186,0,186,9069,1.0254713860403573
V02Q1940086,188,0,188,9170,1.0250817884405672
V02Q1940389,186,0,186,9088,1.0233274647887325
V02Q1940281,184,0,184,8999,1.0223358150905657
V02Q1940697,187,0,187,9149,1.0219696141654826
OC3CL200190,182,0,182,8946,1.0172143974960877
V02Q1940692,185,0,185,9102,1.0162601626016259
OC3CL200207,182,0,182,8971,1.0143796678185264
V02Q1940387,185,0,185,9132,1.012921594393342
OC3CL200211,182,0,182,8994,1.0117856348676897
OC3CL200019,180,0,180,8899,1.0113495898415552
V02Q1940506,184,0,184,9097,1.0113224139826316
OC3CL200215,185,0,185,9154,1.0104872187022067
V02Q1940551,183,0,183,9071,1.0087090728695842
V02Q1940620,182,0,182,9027,1.008086850559433
OC3CL200012,185,0,185,9180,1.0076252723311547
V02Q1940055,183,0,183,9094,1.006157906311854
V02Q1940485,183,0,183,9102,1.0052735662491759
OC3CL200175,184,0,184,9160,1.0043668122270744
OC3CL200017,182,0,182,9070,1.0033076074972436
OC3CL200073,183,0,183,9121,1.0031794759346564
OC3CL200174,184,0,184,9174,1.0028340963592761
V02Q1940593,181,0,181,9037,1.0014385304857807
V02Q1940261,185,0,185,9237,1.0014073833495725
OC3CL200080,179,0,179,8950,1.0
V02Q1940603,182,0,182,9103,0.9996704383170383
V02Q1940397,183,0,183,9181,0.996623461496569
V02Q1940196,184,0,184,9236,0.996102208748376
V02Q1941015,179,0,179,8991,0.9954398843287733
V02Q1940101,182,0,182,9145,0.9950792782941498
OC3CL200188,178,0,178,8957,0.9936362621413419
V02Q1940409,180,0,180,9091,0.989990100098999
V02Q1940582,180,0,180,9102,0.988793671720501
V02Q1940210,180,0,180,9129,0.9858692080184028
V02Q1940133,182,0,182,9233,0.9855951478392722
OC3CL200056,178,0,178,9039,0.9846221927204336
V02Q1940141,178,0,178,9058,0.9825568558180614
OC3CL200100,168,0,168,8551,0.9823412466378202
V02Q1940814,177,0,177,9018,0.9813705921490353
V02Q1940158,180,0,180,9171,0.9813542688910697
V02Q1940658,179,0,179,9127,0.9806069902487126
V02Q1940418,179,0,179,9136,0.9796409807355516
OC3CL200097,176,0,176,8987,0.9791921664626682
OC3CL200112,177,0,177,9046,0.978332964846341
OC3CL200038,175,0,175,8959,0.9766715035160174
V02Q1940345,178,0,178,9137,0.974061508153661
OC3CL200141,174,0,174,8932,0.974025974025974
V02Q1940080,177,0,177,9089,0.9737044779403675
OC3CL200152,176,0,176,9039,0.9735590220157097
V02Q1940795,179,0,179,9216,0.9711371527777778
V02Q1940286,179,0,179,9231,0.9695590943559744
OC3CL200173,177,0,177,9129,0.9694380545514296
V02Q1940803,179,0,179,9237,0.9689293060517483
V02Q1940831,178,0,178,9189,0.9685493524866688
V02Q1940792,178,0,178,9190,0.9684439608269859
V02Q1940297,179,0,179,9246,0.9679861561756434
V02Q1940946,180,0,180,9322,0.9654580562111135
V02Q1940518,176,0,176,9121,0.9648064905163907
OC3CL200191,173,0,173,8966,0.9647557439214811
V02Q1940563,176,0,176,9126,0.9642778873548105
V02Q1940943,179,0,179,9295,0.9628832705755782
V02Q1940787,178,0,178,9247,0.9624743159943766
V02Q1940869,179,0,179,9302,0.9621586755536444
V02Q1940862,179,0,179,9307,0.9616417750080585
V02Q1940103,176,0,176,9154,0.9613283810356128
OC3CL200139,173,0,173,8998,0.9613247388308512
V02Q1940164,177,0,177,9208,0.961120764552563
V02Q1940328,176,0,176,9160,0.9606986899563319
V02Q1940411,175,0,175,9112,0.9602721685689202
V02Q1940093,177,0,177,9217,0.960182271888901
V02Q1940813,177,0,177,9230,0.9588299024918744
OC3CL200193,175,0,175,9127,0.9586939848800263
OC3CL200098,172,0,172,8979,0.9577903998218065
V02Q1940178,176,0,176,9189,0.9576667754924366
V02Q1940942,178,0,178,9295,0.9575040344271113
V02Q1940864,178,0,178,9300,0.9569892473118279
V02Q1940412,174,0,174,9104,0.9556239015817224
V02Q1940498,174,0,174,9106,0.9554140127388535
V02Q1940867,178,0,178,9318,0.9551405881090362
V02Q1940866,178,0,178,9322,0.9547307444754344
V02Q1940847,178,0,178,9326,0.9543212524126099
V02Q1940647,174,0,174,9125,0.9534246575342467
V02Q1940272,176,0,176,9231,0.9533095005958183
OC3CL200171,170,0,170,8920,0.952914798206278
V02Q1940208,175,0,175,9188,0.9523291249455812
V02Q1940194,175,0,175,9212,0.9498480243161094
V02Q1940113,175,0,175,9219,0.9491268033409264
V02Q1940730,173,0,173,9128,0.9476336546888694
V02Q1940476,173,0,173,9139,0.9464930517562097
V02Q1940401,173,0,173,9148,0.9455618714473109
V02Q1940171,174,0,174,9209,0.9447279834944077
V02Q1940600,172,0,172,9105,0.9445359692476661
V02Q1940396,173,0,173,9165,0.9438079650845609
V02Q1940314,170,0,170,9027,0.9416195856873822
V02Q1940747,173,0,173,9188,0.9414453635176318
OC3CL200070,170,0,170,9031,0.9412025246373601
V02Q1940346,172,0,172,9145,0.940404592673592
V02Q1940121,171,0,171,9100,0.9395604395604394
V02Q1940090,172,0,172,9163,0.9385572410782494
V02Q1940757,173,0,173,9222,0.9379744090219041
V02Q1940599,171,0,171,9118,0.9377056372011406
V02Q1940438,171,0,171,9120,0.9375
OC3CL200014,171,0,171,9126,0.9368836291913214
V02Q1940264,173,0,173,9244,0.9357421029857205
OC3CL200052,171,0,171,9140,0.9354485776805251
OC3CL200037,168,0,168,8980,0.9354120267260578
OC3CL200054,169,0,169,9034,0.9353553243303078
V02Q1940553,169,0,169,9045,0.9342177998894416
V02Q1940064,171,0,171,9159,0.9335080248935473
OC3CL200077,168,0,168,9022,0.931057415207271
V02Q1940044,131,0,131,7038,0.9306621199204319
V02Q1940173,172,0,172,9250,0.9297297297297298
V02Q1940566,168,0,168,9036,0.9296148738379815
V02Q1940043,133,0,133,7157,0.9291602626798938
V02Q1940138,170,0,170,9157,0.92825161078956
V02Q1940143,170,0,170,9166,0.927340170194196
V02Q1940161,169,0,169,9141,0.9244065200743902
V02Q1940100,169,0,169,9147,0.9238001530556466
V02Q1940469,167,0,167,9048,0.9228558797524316
V02Q1940256,170,0,170,9228,0.9211096662332033
OC3CL200122,164,0,164,8905,0.9208309938236946
V02Q1940273,170,0,170,9246,0.919316461172399
V02Q1940709,168,0,168,9155,0.9175314036045876
V02Q1940589,167,0,167,9105,0.9170785282811641
OC3CL200115,166,0,166,9062,0.9159126020745972
OC3CL200039,164,0,164,8955,0.9156895589056394
V02Q1940302,168,0,168,9175,0.9155313351498637
V02Q1940559,167,0,167,9125,0.915068493150685
V02Q1940140,166,0,166,9074,0.9147013445007713
V02Q1940505,166,0,166,9078,0.9142983035910993
V02Q1940185,168,0,168,9209,0.9121511564773591
V02Q1940632,163,0,163,8937,0.9119391294617881
OC3CL200078,164,0,164,8992,0.9119217081850534
V02Q1940299,168,0,168,9214,0.9116561753852833
V02Q1940324,167,0,167,9172,0.9103794156127344
V02Q1940782,153,0,153,8407,0.9099559890567384
V02Q1940404,166,0,166,9122,0.9098881824161367
OC3CL200099,163,0,163,8959,0.9096997432749191
V02Q1940629,165,0,165,9070,0.9095920617420067
V02Q1940062,165,0,165,9087,0.9078903928689337
V02Q1940725,167,0,167,9202,0.9074114322973268
V02Q1940724,167,0,167,9203,0.9073128327719221
V02Q1940099,161,0,161,8875,0.9070422535211268
V02Q1940706,166,0,166,9163,0.9058168722034268
V02Q1940224,166,0,166,9174,0.9047307608458687
V02Q1940821,154,0,154,8515,0.9042865531415151
V02Q1940437,165,0,165,9124,0.9042086804033319
V02Q1940546,165,0,165,9132,0.9034165571616295
OC3CL200016,164,0,164,9080,0.9030837004405287
V02Q1940667,164,0,164,9098,0.9012969883490877
V02Q1940739,165,0,165,9183,0.8983992159425025
V02Q1940950,167,0,167,9300,0.8978494623655914
V02Q1940651,163,0,163,9082,0.8973794318432063
V02Q1940231,165,0,165,9203,0.896446810822558
V02Q1940705,164,0,164,9151,0.8960769314828981
V02Q1940588,163,0,163,9096,0.8959982409850483
OC3CL200040,160,0,160,8935,0.8953553441522105
V02Q1940395,164,0,164,9164,0.894805761676124
V02Q1940532,161,0,161,9000,0.8944444444444444
V02Q1940577,163,0,163,9121,0.8935423747396118
V02Q1940623,162,0,162,9071,0.8929555727042222
V02Q1940513,161,0,161,9024,0.8920656028368794
V02Q1940096,164,0,164,9195,0.8917890157694399
OC3CL200192,161,0,161,9032,0.8912754650132861
OC3CL200060,159,0,159,8931,0.8901578770574403
V02Q1940460,162,0,162,9101,0.8900120865838919
OC3CL200168,158,0,158,8882,0.889439315469489
V02Q1940732,161,0,161,9060,0.8885209713024281
OC3CL200020,160,0,160,9021,0.8868196430550936
V02Q1940694,161,0,161,9090,0.8855885588558855
V02Q1940548,161,0,161,9099,0.884712605780855
OC3CL200034,160,0,160,9070,0.8820286659316428
V02Q1940226,160,0,160,9077,0.8813484631486174
V02Q1940689,160,0,160,9092,0.8798944126704795
V02Q1940669,160,0,160,9094,0.8797009016934242
V02Q1940704,161,0,161,9162,0.878629120279415
V02Q1940771,153,0,153,8709,0.878401653461936
V02Q1940655,160,0,160,9109,0.8782522779668459
V02Q1940738,161,0,161,9166,0.8782456905956797
V02Q1940552,159,0,159,9058,0.8776771914329875
V02Q1940169,161,0,161,9174,0.8774798343143666
V02Q1940177,161,0,161,9187,0.8762381626210951
V02Q1940545,147,0,147,8398,0.875208382948321
V02Q1940332,160,0,160,9152,0.8741258741258742
V02Q1940257,161,0,161,9210,0.8740499457111836
V02Q1940624,159,0,159,9105,0.8731466227347612
V02Q1940729,159,0,159,9114,0.8722843976300197
V02Q1940344,159,0,159,9120,0.8717105263157894
V02Q1940570,158,0,158,9072,0.8708112874779541
V02Q1940549,158,0,158,9114,0.8667983322361202
V02Q1940089,158,0,158,9127,0.8655637120631094
V02Q1940638,158,0,158,9140,0.8643326039387309
V02Q1940427,157,0,157,9090,0.8635863586358636
V02Q1940535,154,0,154,8927,0.8625518091184049
V02Q1940578,157,0,157,9112,0.8615013169446883
V02Q1940237,158,0,158,9180,0.8605664488017429
V02Q1940644,157,0,157,9128,0.8599912357581069
V02Q1940481,156,0,156,9104,0.8567662565905098
V02Q1940492,155,0,155,9052,0.8561643835616438
V02Q1940828,154,0,154,8998,0.8557457212713936
OC3CL200167,152,0,152,8909,0.8530699292849928
V02Q1940516,156,0,156,9145,0.8529250956806999
V02Q1940679,156,0,156,9154,0.8520865195542932
V02Q1940408,154,0,154,9080,0.8480176211453744
V02Q1940810,154,0,154,9087,0.8473643666776713
V02Q1940108,156,0,156,9206,0.8472735172713448
V02Q1940198,156,0,156,9208,0.8470894874022589
OC3CL200124,150,0,150,8858,0.846692255588169
V02Q1940384,155,0,155,9154,0.8466244264802272
V02Q1940152,156,0,156,9214,0.8465378771434773
V02Q1940634,153,0,153,9041,0.8461453379050989
V02Q1940876,155,0,155,9166,0.8455160375300022
OC3CL200212,153,0,153,9059,0.844464068881775
V02Q1940717,155,0,155,9189,0.8433997170529981
V02Q1940142,152,0,152,9018,0.842758926591262
V02Q1940636,154,0,154,9139,0.8425429478061057
OC3CL200151,145,0,145,8605,0.84253341080767
V02Q1940502,153,0,153,9098,0.8408441415695757
OC3CL200101,150,0,150,8924,0.8404303003137606
V02Q1940182,135,0,135,8032,0.8403884462151394
V02Q1940580,153,0,153,9112,0.8395522388059702
V02Q1940786,154,0,154,9181,0.8386885960135062
V02Q1940128,154,0,154,9184,0.8384146341463415
V02Q1940282,154,0,154,9187,0.8381408512027866
V02Q1940784,155,0,155,9251,0.8377472705653443
OC3CL200096,151,0,151,9017,0.8373073084174337
V02Q1940880,155,0,155,9259,0.8370234366562264
V02Q1940391,153,0,153,9144,0.8366141732283465
V02Q1940554,152,0,152,9089,0.8361755968753439
V02Q1940116,153,0,153,9160,0.8351528384279476
V02Q1940347,153,0,153,9162,0.8349705304518664
OC3CL200059,150,0,150,8983,0.8349103862852054
V02Q1940811,154,0,154,9224,0.8347788378143973
V02Q1940837,155,0,155,9286,0.8345897049321559
V02Q1940863,155,0,155,9292,0.8340507963839863
V02Q1940850,154,0,154,9235,0.8337845154304278
V02Q1940801,154,0,154,9236,0.8336942399307059
V02Q1940560,152,0,152,9117,0.8336075463419985
V02Q1940941,155,0,155,9297,0.8336022372808434
V02Q1940266,154,0,154,9241,0.8332431555026512
V02Q1940858,155,0,155,9306,0.832796045562003
V02Q1940752,152,0,152,9134,0.8320560543026055
OC3CL200022,149,0,149,8979,0.8297137765898207
OC3CL200118,149,0,149,8980,0.8296213808463251
V02Q1940242,153,0,153,9237,0.8281909710945112
V02Q1940641,151,0,151,9117,0.8281232861686959
V02Q1940579,150,0,150,9057,0.8280887711162637
V02Q1941006,154,0,154,9300,0.8279569892473119
V02Q1940406,150,0,150,9059,0.8279059498840933
V02Q1940826,154,0,154,9303,0.8276899924755455
V02Q1940120,140,0,140,8464,0.82703213610586
V02Q1940845,154,0,154,9316,0.8265349935594677
V02Q1940640,151,0,151,9142,0.825858674250711
OC3CL200123,146,0,146,8844,0.8254183627317956
V02Q1940767,152,0,152,9217,0.8245633069328415
V02Q1940774,151,0,151,9174,0.8229779812513626
OC3CL200120,146,0,146,8875,0.8225352112676056
V02Q1940304,148,0,148,9020,0.8203991130820398
OC3CL200119,147,0,147,8962,0.8201294353938854
V02Q1940148,150,0,150,9167,0.8181520671975565
V02Q1940187,150,0,150,9176,0.8173496076721883
V02Q1940776,151,0,151,9240,0.8170995670995671
V02Q1940648,149,0,149,9118,0.8170651458653213
V02Q1940288,151,0,151,9241,0.8170111459798722
V02Q1940727,150,0,150,9194,0.8157494017837721
OC3CL200063,145,0,145,8897,0.814881420703608
V02Q1940473,148,0,148,9085,0.8145294441386902
OC3CL200125,143,0,143,8805,0.8120386144236229
V02Q1940765,150,0,150,9239,0.8117761662517589
V02Q1940330,149,0,149,9184,0.8111933797909407
OC3CL200130,143,0,143,8841,0.8087320438864383
V02Q1940688,147,0,147,9093,0.8083140877598153
OC3CL200208,145,0,145,8970,0.8082497212931996
V02Q1940668,147,0,147,9106,0.8071601142104108
V02Q1940463,147,0,147,9116,0.8062746818780167
V02Q1940359,147,0,147,9122,0.8057443543082657
V02Q1940374,141,0,141,8750,0.8057142857142856
V02Q1940402,147,0,147,9138,0.804333552199606
V02Q1940405,144,0,144,8960,0.8035714285714285
V02Q1940759,148,0,148,9218,0.8027771750922109
V02Q1940607,146,0,146,9094,0.8027270727952497
OC3CL200121,143,0,143,8908,0.8026493039964078
V02Q1940586,146,0,146,9101,0.80210965827931
OC3CL200083,143,0,143,8918,0.8017492711370262
V02Q1940056,146,0,146,9110,0.8013172338090011
V02Q1940135,147,0,147,9179,0.800740821440244
V02Q1940277,147,0,147,9180,0.8006535947712418
V02Q1940248,148,0,148,9243,0.8006058638970032
V02Q1940380,147,0,147,9182,0.8004791984317142
V02Q1940646,146,0,146,9131,0.7994743182564888
OC3CL200150,141,0,141,8837,0.7977820527328279
V02Q1940291,147,0,147,9216,0.7975260416666666
V02Q1940063,145,0,145,9094,0.7972289421596658
V02Q1940587,145,0,145,9115,0.7953922106417993
V02Q1940360,145,0,145,9115,0.7953922106417993
V02Q1940118,145,0,145,9139,0.7933034248823723
V02Q1940092,146,0,146,9204,0.7931334202520642
V02Q1940339,145,0,145,9174,0.79027686941356
V02Q1940115,145,0,145,9175,0.7901907356948229
V02Q1940337,145,0,145,9196,0.788386254893432
V02Q1940731,143,0,143,9078,0.7876184181537784
V02Q1940104,145,0,145,9205,0.7876154263986964
V02Q1940139,144,0,144,9145,0.7873154729360307
V02Q1940095,145,0,145,9209,0.7872733195786731
V02Q1940527,143,0,143,9090,0.7865786578657866
V02Q1940157,144,0,144,9170,0.7851690294438387
V02Q1940484,143,0,143,9113,0.7845934379457917
V02Q1940547,143,0,143,9117,0.7842492047822749
V02Q1940083,143,0,143,9130,0.783132530120482
V02Q1940276,144,0,144,9195,0.7830342577487764
V02Q1940059,142,0,142,9087,0.7813359744690216
V02Q1940568,141,0,141,9024,0.78125
V02Q1940762,144,0,144,9225,0.7804878048780488
V02Q1940399,143,0,143,9166,0.7800567313986472
V02Q1940639,137,0,137,8798,0.7785860422823369
V02Q1940791,143,0,143,9190,0.7780195865070729
V02Q1940711,142,0,142,9131,0.777570912276859
V02Q1940234,143,0,143,9199,0.7772583976519187
V02Q1940609,141,0,141,9072,0.7771164021164021
V02Q1940221,142,0,142,9153,0.7757019556429586
V02Q1940315,129,0,129,8340,0.7733812949640287
V02Q1940531,140,0,140,9053,0.7732243455208219
V02Q1940719,142,0,142,9192,0.7724107919930374
V02Q1940343,141,0,141,9130,0.7721796276013143
V02Q1940794,142,0,142,9195,0.7721587819467102
V02Q1940094,142,0,142,9199,0.7718230242417654
V02Q1940673,140,0,140,9073,0.7715198941915574
V02Q1940162,141,0,141,9141,0.77125041023958
V02Q1940443,140,0,140,9078,0.7710949548358669
V02Q1940749,141,0,141,9147,0.7707445063955395
V02Q1940879,143,0,143,9277,0.7707232941683734
OC3CL200023,138,0,138,8956,0.7704332291201429
V02Q1940239,142,0,142,9223,0.7698145939499078
V02Q1940524,140,0,140,9096,0.7695690413368513
V02Q1940193,142,0,142,9229,0.7693141185393868
V02Q1940947,143,0,143,9311,0.7679089249275051
V02Q1940945,143,0,143,9322,0.7670027891010514
V02Q1940125,141,0,141,9192,0.7669712793733682
OC3CL200043,136,0,136,8867,0.7668884628397429
V02Q1940124,135,0,135,8803,0.7667840508917415
V02Q1940061,118,0,118,7695,0.7667316439246263
V02Q1940342,140,0,140,9153,0.7647765759860154
V02Q1940615,139,0,139,9090,0.7645764576457645
V02Q1940778,141,0,141,9232,0.7636481802426343
V02Q1940081,138,0,138,9038,0.7634432396547909
V02Q1940424,139,0,139,9105,0.7633168588687534
V02Q1940385,139,0,139,9148,0.7597289024923481
V02Q1940322,140,0,140,9220,0.7592190889370932
V02Q1940398,139,0,139,9174,0.7575757575757576
V02Q1940482,138,0,138,9114,0.7570770243581304
V02Q1940584,138,0,138,9118,0.7567449001974117
V02Q1940252,140,0,140,9268,0.7552870090634441
V02Q1940123,138,0,138,9156,0.7536041939711665
V02Q1940448,137,0,137,9093,0.7533267348509843
V02Q1940334,139,0,139,9226,0.7533058747019293
V02Q1940440,137,0,137,9102,0.7525818501428257
V02Q1940523,137,0,137,9107,0.7521686614691995
OC3CL200065,133,0,133,8861,0.7504796298386187
V02Q1940695,137,0,137,9130,0.7502738225629791
V02Q1940270,138,0,138,9207,0.7494297816878462
V02Q1940307,138,0,138,9213,0.7489417127971344
V02Q1940217,137,0,137,9150,0.7486338797814207
V02Q1940410,136,0,136,9109,0.746514436271819
OC3CL200079,134,0,134,8976,0.7464349376114082
V02Q1940191,137,0,137,9184,0.7458623693379791
V02Q1940489,135,0,135,9057,0.7452798940046373
V02Q1940305,137,0,137,9194,0.7450511202958451
V02Q1940134,137,0,137,9206,0.7440799478600912
OC3CL200131,131,0,131,8812,0.7433045846572855
V02Q1940241,137,0,137,9229,0.7422255932387041
OC3CL200057,134,0,134,9034,0.741642683196812
V02Q1940329,134,0,134,9071,0.7386175724837394
V02Q1940468,134,0,134,9072,0.7385361552028218
V02Q1940583,133,0,133,9017,0.7374958411888655
V02Q1940723,135,0,135,9171,0.7360157016683023
V02Q1940243,136,0,136,9260,0.734341252699784
V02Q1940742,135,0,135,9192,0.7343342036553525
V02Q1940184,135,0,135,9202,0.7335361877852641
OC3CL200172,131,0,131,8942,0.7324983225229256
V02Q1940275,135,0,135,9216,0.732421875
V02Q1940371,134,0,134,9155,0.7318405243036592
V02Q1940126,134,0,134,9167,0.7308825133631504
V02Q1940721,134,0,134,9167,0.7308825133631504
V02Q1940255,135,0,135,9243,0.7302823758519961
V02Q1940616,133,0,133,9111,0.7298869498408517
V02Q1940430,130,0,130,8908,0.7296811854512798
V02Q1940421,133,0,133,9115,0.7295666483817883
V02Q1940617,133,0,133,9116,0.7294866169372533
V02Q1940672,132,0,132,9061,0.7283964242357356
V02Q1940117,133,0,133,9144,0.7272528433945756
OC3CL200084,129,0,129,8889,0.7256159298008774
V02Q1940363,132,0,132,9129,0.7229707525468287
V02Q1940088,133,0,133,9205,0.7224334600760456
V02Q1940657,132,0,132,9137,0.7223377476195687
V02Q1940065,132,0,132,9149,0.7213903158815171
OC3CL200149,127,0,127,8807,0.7210173725445668
V02Q1940678,132,0,132,9154,0.7209962857767096
V02Q1940685,132,0,132,9156,0.7208387942332897
V02Q1940431,131,0,131,9092,0.7204135503739552
V02Q1940167,132,0,132,9172,0.719581334496293
V02Q1940773,132,0,132,9185,0.718562874251497
V02Q1940555,131,0,131,9134,0.7171009415371141
V02Q1940373,131,0,131,9145,0.7162383816293056
V02Q1940301,132,0,132,9215,0.716223548562127
V02Q1940058,130,0,130,9088,0.7152288732394366
V02Q1940789,130,0,130,9100,0.7142857142857143
V02Q1940433,130,0,130,9104,0.7139718804920914
V02Q1940860,130,0,130,9112,0.7133450395083406
V02Q1940188,129,0,129,9050,0.7127071823204421
OC3CL200148,126,0,126,8840,0.7126696832579186
V02Q1940435,130,0,130,9142,0.711004156639685
V02Q1940202,130,0,130,9149,0.710460159580282
V02Q1940797,130,0,130,9160,0.7096069868995634
OC3CL200042,126,0,126,8891,0.7085817118434372
V02Q1940832,131,0,131,9250,0.7081081081081081
OC3CL200062,126,0,126,8913,0.7068327162571525
V02Q1940454,129,0,129,9129,0.7065395990798554
V02Q1940543,129,0,129,9138,0.7058437294812869
V02Q1940349,129,0,129,9141,0.7056120774532327
V02Q1940871,131,0,131,9293,0.7048315936726568
OC3CL200145,125,0,125,8872,0.704463480613165
V02Q1940842,131,0,131,9299,0.7043768147112592
V02Q1940875,131,0,131,9304,0.7039982803095443
OC3CL200103,125,0,125,8878,0.7039873845460689
V02Q1940834,130,0,130,9236,0.70376786487657
OC3CL200092,127,0,127,9030,0.7032115171650055
V02Q1940619,128,0,128,9102,0.7031421665568007
V02Q1940434,128,0,128,9106,0.7028332967274324
OC3CL200147,124,0,124,8830,0.7021517553793885
V02Q1940785,130,0,130,9258,0.7020954849859581
V02Q1940846,131,0,131,9338,0.7014349967873207
V02Q1940179,127,0,127,9056,0.7011925795053003
V02Q1940681,127,0,127,9056,0.7011925795053003
V02Q1940319,129,0,129,9208,0.700477845351868
V02Q1940295,129,0,129,9209,0.7004017808665436
V02Q1940841,130,0,130,9305,0.6985491671144546
V02Q1940843,130,0,130,9305,0.6985491671144546
V02Q1940954,130,0,130,9308,0.6983240223463687
V02Q1940781,129,0,129,9241,0.6979764094794936
OC3CL200170,124,0,124,8884,0.6978838361098605
V02Q1940189,127,0,127,9105,0.6974190005491488
OC3CL200108,123,0,123,8819,0.6973579770949088
V02Q1940413,127,0,127,9109,0.697112745636184
V02Q1940955,130,0,130,9349,0.6952615252968232
V02Q1940691,126,0,126,9077,0.6940619147295362
V02Q1940313,128,0,128,9240,0.6926406926406926
V02Q1940073,127,0,127,9168,0.6926265270506108
V02Q1940764,128,0,128,9246,0.6921912178239239
V02Q1940573,125,0,125,9049,0.690684053486573
OC3CL200061,123,0,123,8934,0.6883814640698456
V02Q1940453,125,0,125,9105,0.6864360241625481
V02Q1940462,125,0,125,9109,0.6861345921615984
OC3CL200102,122,0,122,8893,0.6859327561003036
V02Q1940572,124,0,124,9058,0.684477809671009
V02Q1940165,121,0,121,8868,0.6822282363554353
V02Q1940428,121,0,121,8882,0.6811528934924567
V02Q1940163,125,0,125,9189,0.6801610621395147
OC3CL200026,121,0,121,8895,0.6801573917931422
V02Q1940309,125,0,125,9190,0.6800870511425462
V02Q1940311,125,0,125,9190,0.6800870511425462
V02Q1940325,125,0,125,9199,0.6794216762691597
V02Q1940605,122,0,122,8994,0.6782299310651546
OC3CL200086,122,0,122,8996,0.6780791462872388
V02Q1940200,124,0,124,9151,0.6775215823407278
V02Q1940561,122,0,122,9005,0.6774014436424208
V02Q1940628,121,0,121,8937,0.6769609488642722
V02Q1940748,124,0,124,9162,0.6767081423270028
V02Q1940754,124,0,124,9164,0.6765604539502401
V02Q1940170,124,0,124,9169,0.6761915148871196
V02Q1940353,124,0,124,9171,0.6760440519027369
V02Q1940294,125,0,125,9257,0.675164740196608
OC3CL200111,121,0,121,8966,0.6747713584653134
V02Q1940351,123,0,123,9126,0.6738987508218277
OC3CL200058,121,0,121,8980,0.6737193763919822
V02Q1940426,122,0,122,9063,0.6730663135826989
V02Q1940626,122,0,122,9080,0.6718061674008811
V02Q1940220,124,0,124,9229,0.6717954274569292
V02Q1940649,122,0,122,9082,0.6716582250605593
V02Q1940285,124,0,124,9232,0.67157712305026
V02Q1940376,123,0,123,9162,0.6712508185985593
V02Q1940357,123,0,123,9165,0.6710310965630115
V02Q1940606,122,0,122,9095,0.6706981858163826
OC3CL200064,119,0,119,8881,0.6699695980182412
V02Q1940354,123,0,123,9185,0.6695699510070767
V02Q1940750,120,0,120,8973,0.6686726847208292
V02Q1940269,123,0,123,9207,0.6679700228087325
V02Q1940631,121,0,121,9065,0.6674020959735245
OC3CL200090,121,0,121,9073,0.6668136228369889
V02Q1940637,120,0,120,9041,0.6636434022785089
V02Q1940504,121,0,121,9118,0.6635227023470058
V02Q1940077,121,0,121,9129,0.6627231898345931
OC3CL200088,119,0,119,8979,0.6626573115046219
V02Q1940268,119,0,119,8982,0.6624359830772656
V02Q1940529,120,0,120,9078,0.6609385327164574
V02Q1940442,120,0,120,9084,0.6605019815059445
V02Q1940076,118,0,118,8940,0.6599552572706936
V02Q1940254,122,0,122,9249,0.659530760082171
V02Q1940528,117,0,117,8877,0.6590064210882054
V02Q1940415,120,0,120,9131,0.657102179388895
OC3CL200041,114,0,114,8681,0.6566063817532543
OC3CL200025,117,0,117,8912,0.6564183123877918
V02Q1940176,121,0,121,9221,0.6561110508621624
V02Q1940444,119,0,119,9087,0.6547815560691097
V02Q1940758,120,0,120,9192,0.6527415143603132
V02Q1940661,119,0,119,9117,0.652626960623012
V02Q1940595,119,0,119,9126,0.6519833442910367
V02Q1940574,118,0,118,9073,0.6502810536757412
V02Q1940356,119,0,119,9150,0.6502732240437159
V02Q1940280,119,0,119,9178,0.6482893876661582
V02Q1940722,119,0,119,9180,0.6481481481481481
V02Q1940441,118,0,118,9112,0.6474978050921861
V02Q1940308,117,0,117,9051,0.6463374212794166
V02Q1940403,118,0,118,9132,0.6460797196671046
V02Q1940571,117,0,117,9055,0.6460519050248481
V02Q1940392,118,0,118,9135,0.6458675424192666
OC3CL200067,114,0,114,8845,0.644431882419446
V02Q1940743,118,0,118,9158,0.6442454684428914
V02Q1940467,117,0,117,9089,0.6436351633843107
V02Q1940355,118,0,118,9172,0.6432621020497165
V02Q1940068,118,0,118,9181,0.6426315216207384
V02Q1940209,118,0,118,9190,0.6420021762785636
V02Q1940763,118,0,118,9193,0.6417926683346024
V02Q1940323,118,0,118,9202,0.6411649641382309
V02Q1940439,117,0,117,9128,0.6408851884312008
V02Q1940456,117,0,117,9129,0.6408149852119619
OC3CL200082,114,0,114,8896,0.6407374100719424
V02Q1940944,119,0,119,9291,0.6404046927133785
V02Q1940622,116,0,116,9064,0.6398940864960283
V02Q1940949,119,0,119,9308,0.6392350666093682
V02Q1940715,117,0,117,9155,0.638995084653195
V02Q1940423,116,0,116,9097,0.6375728262064417
V02Q1940461,116,0,116,9099,0.6374326849104297
V02Q1940592,115,0,115,9041,0.6359915938502378
V02Q1940822,118,0,118,9279,0.6358443797823041
V02Q1940951,118,0,118,9294,0.6348181622552184
V02Q1940459,115,0,115,9060,0.6346578366445916
OC3CL200091,113,0,113,8922,0.6332660838377046
V02Q1940341,116,0,116,9159,0.6332569057757398
OC3CL200018,114,0,114,9020,0.6319290465631929
OC3CL200081,113,0,113,8945,0.6316377864728898
OC3CL200127,111,0,111,8816,0.6295372050816697
V02Q1940522,114,0,114,9059,0.6292085219119109
V02Q1940507,114,0,114,9073,0.628237628127411
V02Q1940293,116,0,116,9249,0.6270948210617364
V02Q1940575,112,0,112,8984,0.6233303650934996
V02Q1940070,114,0,114,9162,0.6221349050425672
V02Q1940310,114,0,114,9184,0.6206445993031359
V02Q1940225,114,0,114,9194,0.6199695453556667
V02Q1940284,114,0,114,9208,0.6190269331016508
V02Q1940614,112,0,112,9047,0.6189897203492871
V02Q1940511,112,0,112,9055,0.6184428492545555
V02Q1940147,113,0,113,9153,0.6172839506172839
V02Q1940720,113,0,113,9167,0.6163412239554925
V02Q1940716,113,0,113,9197,0.6143307600304447
V02Q1940259,113,0,113,9209,0.6135302421544141
V02Q1940734,111,0,111,9088,0.6106954225352113
V02Q1940670,111,0,111,9091,0.6104938950610493
V02Q1940263,113,0,113,9264,0.6098877374784111
OC3CL200048,107,0,107,8801,0.6078854675605044
V02Q1940740,111,0,111,9182,0.6044434763668046
V02Q1940422,108,0,108,8940,0.6040268456375839
V02Q1940432,109,0,109,9086,0.5998239049086507
V02Q1940149,105,0,105,8788,0.5974055530268547
V02Q1940643,109,0,109,9123,0.5973912090321166
V02Q1940499,109,0,109,9124,0.5973257343270495
V02Q1940714,109,0,109,9124,0.5973257343270495
V02Q1940091,110,0,110,9215,0.5968529571351058
V02Q1940533,108,0,108,9056,0.5962897526501767
V02Q1940394,109,0,109,9145,0.5959540732640788
V02Q1940656,109,0,109,9150,0.5956284153005464
V02Q1940159,109,0,109,9168,0.5944589877835951
V02Q1940057,108,0,108,9113,0.5925600790080106
OC3CL200085,105,0,105,8874,0.5916159567275185
V02Q1940127,107,0,107,9093,0.5883646761244914
V02Q1940326,108,0,108,9186,0.5878510777269758
V02Q1940809,107,0,107,9116,0.5868802106186924
OC3CL200027,104,0,104,8861,0.5868412143098972
OC3CL200128,103,0,103,8779,0.5866271784941337
V02Q1940519,107,0,107,9132,0.5858519491896628
OC3CL200110,104,0,104,8878,0.5857175039423294
V02Q1940186,107,0,107,9138,0.5854672794922302
V02Q1940660,107,0,107,9140,0.5853391684901532
OC3CL200047,103,0,103,8816,0.5841651542649728
V02Q1940807,108,0,108,9247,0.58397318049097
V02Q1940693,106,0,106,9076,0.5839576906126046
V02Q1940804,107,0,107,9179,0.5828521625449395
V02Q1940793,107,0,107,9179,0.5828521625449395
V02Q1940798,107,0,107,9188,0.5822812363952983
V02Q1940172,107,0,107,9189,0.5822178691914246
V02Q1940223,107,0,107,9191,0.582091176150582
OC3CL200045,103,0,103,8848,0.5820524412296565
OC3CL200089,104,0,104,8948,0.581135449262405
V02Q1940557,106,0,106,9131,0.5804402584601905
V02Q1940868,108,0,108,9308,0.5801461108723679
OC3CL200107,102,0,102,8794,0.5799408687741642
V02Q1940770,104,0,104,8985,0.5787423483583751
V02Q1940122,102,0,102,8813,0.578690570747759
V02Q1940882,107,0,107,9253,0.5781908570193451
V02Q1940131,106,0,106,9178,0.5774678579211158
V02Q1940853,107,0,107,9272,0.5770060396893875
V02Q1940271,106,0,106,9202,0.5759617474462073
V02Q1940839,107,0,107,9290,0.5758880516684608
OC3CL200104,102,0,102,8856,0.575880758807588
V02Q1940540,105,0,105,9117,0.5758473181967753
V02Q1940675,105,0,105,9120,0.575657894736842
V02Q1940889,107,0,107,9298,0.5753925575392558
OC3CL200044,102,0,102,8869,0.5750366444920509
OC3CL200109,101,0,101,8804,0.5736029077691958
V02Q1940218,106,0,106,9242,0.5734689461155594
V02Q1940501,104,0,104,9072,0.5731922398589064
V02Q1940475,104,0,104,9113,0.5706134094151213
V02Q1940420,104,0,104,9117,0.5703630580234726
V02Q1940464,104,0,104,9126,0.5698005698005698
V02Q1940262,105,0,105,9219,0.5694760820045558
OC3CL200129,100,0,100,8782,0.5693463903438852
V02Q1940250,105,0,105,9224,0.5691673894189072
V02Q1940425,103,0,103,9087,0.5667436997909101
V02Q1940327,104,0,104,9184,0.5662020905923345
V02Q1940085,104,0,104,9186,0.5660788155889397
V02Q1940612,102,0,102,9032,0.5646589902568644
V02Q1940508,100,0,100,8872,0.563570784490532
V02Q1940265,103,0,103,9147,0.5630261287853942
V02Q1940713,101,0,101,8972,0.562862238074008
V02Q1940051,103,0,103,9161,0.5621657024342321
V02Q1940049,103,0,103,9165,0.5619203491543917
V02Q1940199,103,0,103,9172,0.5614914958569559
V02Q1940539,102,0,102,9128,0.5587204206836108
V02Q1940144,103,0,103,9229,0.5580236211940622
V02Q1940195,103,0,103,9239,0.5574196341595411
V02Q1940414,101,0,101,9123,0.5535459826811356
V02Q1940197,102,0,102,9222,0.5530253741054001
V02Q1940487,99,0,99,8997,0.5501833944648216
V02Q1940450,99,0,99,9021,0.5487196541403392
V02Q1940525,100,0,100,9123,0.5480653293872629
V02Q1940581,98,0,98,8946,0.5477308294209703
V02Q1940393,100,0,100,9140,0.5470459518599562
OC3CL200196,100,0,100,9173,0.545077946146299
V02Q1940745,100,0,100,9194,0.5438329345225147
V02Q1940111,100,0,100,9227,0.5418879375745096
V02Q1940710,84,0,84,7819,0.5371530886302597
V02Q1940701,98,0,98,9139,0.5361636940584309
V02Q1940680,98,0,98,9147,0.535694763310375
V02Q1940046,98,0,98,9177,0.5339435545385203
V02Q1940206,98,0,98,9197,0.532782429052952
V02Q1940249,98,0,98,9215,0.5317417254476398
OC3CL200105,94,0,94,8840,0.5316742081447964
V02Q1940610,96,0,96,9060,0.5298013245033113
V02Q1940625,96,0,96,9114,0.5266622778143515
V02Q1940761,97,0,97,9214,0.5263729107879314
V02Q1940287,97,0,97,9218,0.5261444998915167
V02Q1940478,96,0,96,9132,0.5256241787122208
V02Q1940835,96,0,96,9233,0.5198743636954403
V02Q1940075,95,0,95,9144,0.5194663167104112
V02Q1940790,95,0,95,9204,0.5160799652325075
V02Q1940321,95,0,95,9205,0.5160239000543183
OC3CL200069,91,0,91,8821,0.5158145334996032
V02Q1940777,93,0,93,9045,0.5140961857379768
V02Q1940367,94,0,94,9153,0.5134928438763247
V02Q1940873,95,0,95,9274,0.5121846021134354
V02Q1940884,95,0,95,9284,0.511632916846187
V02Q1940576,93,0,93,9118,0.5099802588286905
V02Q1940887,95,0,95,9323,0.5094926525796417
V02Q1940799,94,0,94,9229,0.5092642756528334
V02Q1940544,93,0,93,9132,0.5091984231274638
V02Q1940800,94,0,94,9234,0.5089885206844271
V02Q1940590,92,0,92,9067,0.5073342891805449
V02Q1940819,94,0,94,9276,0.5066839154808107
V02Q1940827,94,0,94,9287,0.5060837730160439
V02Q1940074,92,0,92,9105,0.5052169137836354
V02Q1940712,92,0,92,9107,0.5051059624464697
V02Q1940952,94,0,94,9306,0.5050505050505051
V02Q1940119,92,0,92,9138,0.5033924272269643
V02Q1940698,92,0,92,9146,0.5029521102121146
V02Q1940078,91,0,91,9121,0.49884881043745205
OC3CL200106,88,0,88,8827,0.498470601563385
V02Q1940509,89,0,89,8973,0.49593224116794826
V02Q1940684,91,0,91,9185,0.4953728905824714
V02Q1940769,91,0,91,9194,0.4948879704154884
V02Q1940318,91,0,91,9230,0.49295774647887325
V02Q1940054,90,0,90,9135,0.49261083743842365
V02Q1940292,90,0,90,9148,0.49191080017490163
V02Q1940296,91,0,91,9258,0.49146683949017067
V02Q1940417,90,0,90,9161,0.49121274969981443
V02Q1940338,90,0,90,9181,0.4901426859819192
V02Q1940232,89,0,89,9097,0.4891722545894251
OC3CL200068,86,0,86,8830,0.4869762174405436
OC3CL200066,86,0,86,8845,0.4861503674392312
OC3CL200046,86,0,86,8846,0.4860954103549627
V02Q1940106,89,0,89,9169,0.485331006652852
V02Q1940340,88,0,88,9076,0.48479506390480387
V02Q1940483,88,0,88,9109,0.4830387528817653
OC3CL200049,85,0,85,8804,0.48273512039981825
V02Q1940479,88,0,88,9119,0.48250904704463204
V02Q1940753,88,0,88,9148,0.4809794490599038
OC3CL200029,85,0,85,8856,0.4799006323396567
V02Q1940718,88,0,88,9185,0.47904191616766467
V02Q1940316,88,0,88,9238,0.4762935700368045
V02Q1940390,87,0,87,9152,0.4753059440559441
V02Q1940674,86,0,86,9086,0.4732555580013207
V02Q1940449,86,0,86,9092,0.4729432468103828
V02Q1940335,86,0,86,9178,0.468511658313358
V02Q1940521,85,0,85,9111,0.4664691032817473
V02Q1940598,85,0,85,9118,0.46611098925202893
V02Q1940112,86,0,86,9247,0.465015680761328
V02Q1940735,85,0,85,9145,0.4647348277747403
V02Q1940512,84,0,84,9057,0.4637297118251077
V02Q1940687,82,0,82,8849,0.46332918973895354
V02Q1940447,84,0,84,9076,0.4627589246364037
V02Q1940407,84,0,84,9089,0.4620970403784795
V02Q1940156,84,0,84,9177,0.4576659038901602
V02Q1940079,83,0,83,9068,0.45765328628142915
V02Q1940136,84,0,84,9194,0.45681966499891236
V02Q1940500,83,0,83,9089,0.45659588513587857
V02Q1940755,84,0,84,9199,0.4565713664528753
V02Q1940562,83,0,83,9114,0.4553434276936581
V02Q1940386,83,0,83,9157,0.4532051982090204
V02Q1940874,84,0,84,9271,0.4530255635853737
OC3CL200021,79,0,79,8725,0.4527220630372493
V02Q1940818,84,0,84,9281,0.4525374420859821
V02Q1940854,84,0,84,9283,0.45243994398362597
V02Q1940060,82,0,82,9085,0.45129334067143645
V02Q1940948,84,0,84,9307,0.45127323519931234
V02Q1940848,84,0,84,9318,0.4507405022537025
V02Q1940320,83,0,83,9218,0.45020611846387504
V02Q1940696,82,0,82,9157,0.44774489461614064
V02Q1940493,81,0,81,9068,0.44662549625055137
V02Q1940192,82,0,82,9226,0.4443962714068936
V02Q1940538,81,0,81,9125,0.4438356164383562
V02Q1940686,81,0,81,9132,0.4434954007884363
V02Q1940071,81,0,81,9168,0.4417539267015707
V02Q1940520,80,0,80,9080,0.4405286343612335
V02Q1940369,78,0,78,9007,0.43299655823248584
V02Q1940496,79,0,79,9131,0.43259226809768925
V02Q1940702,78,0,78,9157,0.4259036802446216
V02Q1940175,78,0,78,9231,0.42248943776405595
OC3CL200028,75,0,75,8888,0.4219171917191719
V02Q1940348,75,0,75,9023,0.41560456610883295
V02Q1940372,76,0,76,9149,0.4153459394469341
V02Q1940045,72,0,72,8843,0.40710166233178785
V02Q1940796,72,0,72,8862,0.4062288422477996
V02Q1940451,73,0,73,9099,0.4011429827453566
V02Q1940480,71,0,71,8916,0.39816061013907583
V02Q1940205,72,0,72,9075,0.39669421487603307
V02Q1940495,71,0,71,9103,0.3899813248379655
V02Q1940604,71,0,71,9117,0.38938247230448614
V02Q1940817,72,0,72,9275,0.3881401617250674
V02Q1940751,71,0,71,9151,0.3879357447273522
V02Q1940870,72,0,72,9283,0.3878056662716794
V02Q1940855,72,0,72,9295,0.3873050026896181
V02Q1940849,72,0,72,9301,0.38705515535963875
V02Q1941013,72,0,72,9302,0.38701354547409156
V02Q1940886,72,0,72,9331,0.38581073839888547
V02Q1940517,70,0,70,9140,0.38293216630196936
V02Q1940567,69,0,69,9090,0.3795379537953795
V02Q1940333,67,0,67,9194,0.3643680661300849
V02Q1940594,64,0,64,9082,0.35234529839242457
V02Q1940416,64,0,64,9127,0.35060808589898107
V02Q1940235,64,0,64,9202,0.3477504890241252
V02Q1940621,62,0,62,9088,0.34110915492957744
V02Q1940219,62,0,62,9235,0.33567948023822414
V02Q1940072,60,0,60,9164,0.3273679615888258
V02Q1940052,60,0,60,9175,0.32697547683923706
V02Q1940312,57,0,57,9204,0.30964797913950454
V02Q1940247,40,0,40,9243,0.21637996321540626
V02Q1940838,1,1,2,7301,0.013696753869332967
V02Q1940350,2,0,2,8398,0.011907597046915932
OC3CL200232,1,0,1,7118,0.007024445068839562
OC3CL200072,0,0,0,8484,0.0
V02Q1940865,0,0,0,7347,0.0
OC3CL200087,0,0,0,8583,0.0
V02Q1940883,0,0,0,8699,0.0
V02Q1940859,0,0,0,8486,0.0
OC3CL200166,0,0,0,8403,0.0
V02Q1941000,0,0,0,7440,0.0
OC3CL200216,0,0,0,8292,0.0
V02Q1940183,0,0,0,7899,0.0
V02Q1940852,0,0,0,8601,0.0
OC3CL200253,0,0,0,6523,0.0
V02Q1940812,0,0,0,7412,0.0
OC3CL200255,0,0,0,6541,0.0
OC3CL200256,0,0,0,6423,0.0
OC3CL200257,0,0,0,6507,0.0
OC3CL200258,0,0,0,866,0.0
OC3CL200259,0,0,0,5415,0.0
OT2CL190005,0,0,0,1,0.0
OT2CL190056,0,0,0,106,0.0
OT2CL190058,0,0,0,97,0.0
V02Q1940047,0,0,0,7317,0.0
V02Q1940146,0,0,0,8236,0.0
V02Q1940151,0,0,0,8395,0.0
V02Q1940154,0,0,0,7402,0.0
V02Q1940236,0,0,0,8549,0.0
V02Q1940238,0,0,0,8515,0.0
V02Q1940278,0,0,0,7622,0.0
V02Q1940290,0,0,0,8473,0.0
V02Q1940429,0,0,0,7601,0.0
V02Q1940436,0,0,0,8432,0.0
V02Q1940474,0,0,0,6974,0.0
V02Q1940491,0,0,0,7782,0.0
V02Q1940494,0,0,0,7549,0.0
V02Q1940601,0,0,0,8394,0.0
OC3CL200254,0,0,0,6381,0.0
OC3CL200252,0,0,0,6505,0.0
OC3CL200217,0,0,0,8269,0.0
OC3CL200251,0,0,0,6290,0.0
OC3CL200218,0,0,0,7132,0.0
OC3CL200230,0,0,0,6506,0.0
OC3CL200231,0,0,0,6378,0.0
V02Q1940844,0,0,0,9297,0.0
OC3CL200233,0,0,0,6169,0.0
OC3CL200234,0,0,0,6496,0.0
OC3CL200235,0,0,0,6297,0.0
OC3CL200236,0,0,0,6210,0.0
OC3CL200237,0,0,0,6416,0.0
OC3CL200238,0,0,0,5887,0.0
OC3CL200239,0,0,0,6543,0.0
OC3CL200240,0,0,0,5912,0.0
OC3CL200241,0,0,0,6494,0.0
OC3CL200242,0,0,0,6329,0.0
OC3CL200243,0,0,0,6361,0.0
OC3CL200244,0,0,0,6499,0.0
OC3CL200245,0,0,0,6595,0.0
OC3CL200246,0,0,0,6448,0.0
V02Q1940825,0,0,0,7383,0.0
OC3CL200247,0,0,0,5841,0.0
OC3CL200248,0,0,0,6321,0.0
OC3CL200249,0,0,0,6114,0.0
OC3CL200250,0,0,0,6161,0.0
OC3CL200008,0,0,0,457,0.0
