시리얼,온도 평균(℃),습도 평균(%),총 결측 수,총 행 수,결측률 (%)
V02Q1940437,6747,6747,13494,6828,98.81370826010544
V02Q1940700,7286,7286,14572,7415,98.26028320971004
V02Q1940421,5414,5414,10828,5765,93.91153512575889
V02Q1940055,5913,5913,11826,6338,93.29441464184285
V02Q1940352,5355,5355,10710,6731,79.5572723220918
OC3CL200062,5695,5695,11390,7331,77.6838084845178
V02Q1940129,5669,5669,11338,7337,77.2659124982963
V02Q1940756,5338,5338,10676,7192,74.22135706340379
V02Q1940090,4417,4417,8834,6629,66.63146779303062
V02Q1940368,4092,4092,8184,6892,59.37318630295996
V02Q1940788,4054,4054,8108,7320,55.38251366120218
V02Q1940853,3636,3636,7272,6863,52.97974646655982
V02Q1940658,3735,3735,7470,7205,51.839000693962525
V02Q1940262,3680,3680,7360,7152,51.45413870246085
OC3CL210108,3562,3562,7124,6956,51.20759056929269
V02Q1940447,3742,3742,7484,7309,51.197154193460115
OC3CL200131,3736,3736,7472,7385,50.58903182125931
V02Q1940436,3791,3791,7582,7496,50.573639274279614
V02Q1940312,3659,3659,7318,7361,49.70792011954897
V02Q1940525,3485,3485,6970,7014,49.686341602509266
OC3CL200168,3324,3324,6648,6757,49.19342903655469
V02Q1940604,3644,3644,7288,7453,48.89306319602845
OC3CL200195,3610,3610,7220,7392,48.83658008658009
V02Q1940158,3471,3471,6942,7252,47.86265857694429
V02Q1940362,3439,3439,6878,7328,46.92958515283843
OC3CL200210,3090,3090,6180,6667,46.3476826158692
V02Q1940618,3399,3399,6798,7421,45.80245249966312
V02Q1940506,3367,3367,6734,7358,45.75971731448763
OC3CL200014,3384,3384,6768,7412,45.65569347004857
V02Q1940838,1654,1654,3308,3661,45.17891286533734
OC3CL200039,2922,2922,5844,6694,43.65103077382731
V02Q1940796,1449,1449,2898,3727,38.878454521062515
OC3CL200205,2715,2715,5430,7336,37.0092693565976
V02Q1940460,2464,2464,4928,7270,33.89270976616231
OC3CL210106,2252,2252,4504,7073,31.839389226636506
OC3CL200153,1753,1753,3506,5523,31.73999637877965
V02Q1940731,2156,2156,4312,7213,29.890475530292527
OC3CL200072,2029,2029,4058,7331,27.676988132587642
V02Q1940654,1604,1604,3208,6327,25.351667456930617
OC3CL200225,1316,1316,2632,5945,22.136248948696384
V02Q1940079,1245,1245,2490,5692,21.872803935347857
V02Q1940239,1249,1249,2498,5929,21.065947039973015
V02Q1940690,1410,1410,2820,6842,20.608009353990063
V02Q1940126,963,963,1926,4751,20.269416964849505
V02Q1940518,1304,1304,2608,7369,17.695752476591124
V02Q1940357,719,719,1438,4326,16.620434581599632
V02Q1940722,393,393,786,2704,14.534023668639055
OC3CL200254,338,338,676,2541,13.30184966548603
V02Q1940593,385,385,770,3288,11.709245742092458
V02Q1940750,391,391,782,4125,9.478787878787879
V02Q1940332,614,614,1228,6825,8.996336996336996
V02Q1940575,380,380,760,4529,8.390373150805917
V02Q1940611,553,553,1106,7368,7.5054288816503805
V02Q1940662,354,354,708,5035,7.030784508440914
V02Q1940632,281,281,562,4496,6.25
V02Q1940688,183,183,366,3169,5.7746923319659205
V02Q1940311,177,177,354,4160,4.2548076923076925
V02Q1940691,133,133,266,3128,4.251918158567776
V02Q1940124,178,178,356,4849,3.6708599711280674
V02Q1940677,173,173,346,5161,3.3520635535748884
V02Q1940935,199,199,398,6869,2.8970738098704327
V02Q1940852,122,122,244,4521,2.6985180269851803
V02Q1940424,152,152,304,7483,2.0312708806628357
OC3CL200156,63,63,126,4893,1.2875536480686696
V02Q1940511,57,57,114,5169,1.1027278003482297
V02Q1940530,52,52,104,6140,0.8469055374592834
V02Q1940581,48,48,96,6212,0.7726980038634901
V02Q1940552,34,34,68,4522,0.7518796992481203
V02Q1940831,2,2,4,3829,0.05223295899712719
V02Q1940226,1,1,2,5019,0.019924287706714484
V02Q1940130,1,1,2,5450,0.01834862385321101
V02Q1940150,1,1,2,5648,0.017705382436260624
V02Q1940473,1,1,2,5816,0.0171939477303989
V02Q1940579,1,1,2,5825,0.017167381974248927
V02Q1940519,1,1,2,5872,0.017029972752043595
V02Q1940068,1,1,2,5944,0.016823687752355317
V02Q1940609,0,0,0,7380,0.0
V02Q1940532,0,0,0,7172,0.0
V02Q1940533,0,0,0,5676,0.0
V02Q1940534,0,0,0,6886,0.0
V02Q1940608,0,0,0,7425,0.0
V02Q1940535,0,0,0,4623,0.0
V02Q1940536,0,0,0,7242,0.0
V02Q1940577,0,0,0,5754,0.0
V02Q1940607,0,0,0,6745,0.0
V02Q1940537,0,0,0,7066,0.0
V02Q1940610,0,0,0,4198,0.0
V02Q1940606,0,0,0,7421,0.0
V02Q1940538,0,0,0,7171,0.0
V02Q1940605,0,0,0,7372,0.0
V02Q1940539,0,0,0,7354,0.0
V02Q1940540,0,0,0,7351,0.0
V02Q1940541,0,0,0,7444,0.0
V02Q1940542,0,0,0,7428,0.0
V02Q1940543,0,0,0,7457,0.0
V02Q1940531,0,0,0,7365,0.0
V02Q1940529,0,0,0,415,0.0
V02Q1940612,0,0,0,7078,0.0
V02Q1940520,0,0,0,7426,0.0
V02Q1940512,0,0,0,6648,0.0
V02Q1940513,0,0,0,6423,0.0
V02Q1940514,0,0,0,7433,0.0
V02Q1940515,0,0,0,6682,0.0
V02Q1940619,0,0,0,7407,0.0
V02Q1940617,0,0,0,7335,0.0
V02Q1940516,0,0,0,7095,0.0
V02Q1940517,0,0,0,6996,0.0
V02Q1940616,0,0,0,6820,0.0
V02Q1940521,0,0,0,7289,0.0
V02Q1940613,0,0,0,6797,0.0
V02Q1940522,0,0,0,6654,0.0
V02Q1940615,0,0,0,6659,0.0
V02Q1940523,0,0,0,6346,0.0
V02Q1940524,0,0,0,7268,0.0
V02Q1940614,0,0,0,4278,0.0
V02Q1940526,0,0,0,7325,0.0
V02Q1940527,0,0,0,6741,0.0
V02Q1940528,0,0,0,4604,0.0
V02Q1940603,0,0,0,7290,0.0
V02Q1940544,0,0,0,7467,0.0
V02Q1940547,0,0,0,1301,0.0
V02Q1940545,0,0,0,6737,0.0
V02Q1940594,0,0,0,7320,0.0
V02Q1940592,0,0,0,7442,0.0
V02Q1940564,0,0,0,7456,0.0
V02Q1940565,0,0,0,7247,0.0
V02Q1940566,0,0,0,7403,0.0
V02Q1940591,0,0,0,6570,0.0
V02Q1940590,0,0,0,6153,0.0
V02Q1940567,0,0,0,7374,0.0
V02Q1940588,0,0,0,7286,0.0
V02Q1940569,0,0,0,6509,0.0
V02Q1940570,0,0,0,7413,0.0
V02Q1940571,0,0,0,6780,0.0
V02Q1940586,0,0,0,7437,0.0
V02Q1940572,0,0,0,7299,0.0
V02Q1940573,0,0,0,6689,0.0
V02Q1940574,0,0,0,23,0.0
V02Q1940585,0,0,0,6237,0.0
V02Q1940584,0,0,0,7310,0.0
V02Q1940583,0,0,0,5698,0.0
V02Q1940582,0,0,0,7257,0.0
V02Q1940576,0,0,0,7390,0.0
V02Q1940580,0,0,0,7287,0.0
V02Q1940563,0,0,0,7307,0.0
V02Q1940595,0,0,0,23,0.0
V02Q1940546,0,0,0,7445,0.0
V02Q1940562,0,0,0,7501,0.0
V02Q1940602,0,0,0,7387,0.0
V02Q1940578,0,0,0,7178,0.0
V02Q1940601,0,0,0,7288,0.0
V02Q1940600,0,0,0,7360,0.0
V02Q1940548,0,0,0,7168,0.0
V02Q1940549,0,0,0,7155,0.0
V02Q1940550,0,0,0,7088,0.0
V02Q1940551,0,0,0,4891,0.0
V02Q1940599,0,0,0,7444,0.0
V02Q1940553,0,0,0,7023,0.0
V02Q1940554,0,0,0,6978,0.0
V02Q1940598,0,0,0,7505,0.0
V02Q1940597,0,0,0,7398,0.0
V02Q1940555,0,0,0,7098,0.0
V02Q1940556,0,0,0,4664,0.0
V02Q1940557,0,0,0,6019,0.0
V02Q1940558,0,0,0,7145,0.0
V02Q1940559,0,0,0,7300,0.0
V02Q1940560,0,0,0,6913,0.0
V02Q1940561,0,0,0,7145,0.0
V02Q1940596,0,0,0,7440,0.0
OC3CL200008,0,0,0,10964,0.0
V02Q1940495,0,0,0,6955,0.0
V02Q1940510,0,0,0,7051,0.0
V02Q1940415,0,0,0,7140,0.0
V02Q1940401,0,0,0,7149,0.0
V02Q1940402,0,0,0,6935,0.0
V02Q1940403,0,0,0,7164,0.0
V02Q1940404,0,0,0,7222,0.0
V02Q1940405,0,0,0,6311,0.0
V02Q1940406,0,0,0,7331,0.0
V02Q1940407,0,0,0,6847,0.0
V02Q1940408,0,0,0,6087,0.0
V02Q1940409,0,0,0,7310,0.0
V02Q1940410,0,0,0,6719,0.0
V02Q1940411,0,0,0,7262,0.0
V02Q1940412,0,0,0,7241,0.0
V02Q1940413,0,0,0,7276,0.0
V02Q1940414,0,0,0,7339,0.0
V02Q1940416,0,0,0,7303,0.0
V02Q1940399,0,0,0,7279,0.0
V02Q1940417,0,0,0,6756,0.0
V02Q1940418,0,0,0,7367,0.0
V02Q1940419,0,0,0,7210,0.0
V02Q1940420,0,0,0,7219,0.0
V02Q1940422,0,0,0,7415,0.0
V02Q1940425,0,0,0,7367,0.0
V02Q1940426,0,0,0,7402,0.0
V02Q1940427,0,0,0,7332,0.0
V02Q1940428,0,0,0,6373,0.0
V02Q1940429,0,0,0,7420,0.0
V02Q1940430,0,0,0,6776,0.0
V02Q1940431,0,0,0,7402,0.0
V02Q1940432,0,0,0,7089,0.0
V02Q1940433,0,0,0,6793,0.0
V02Q1940400,0,0,0,7423,0.0
V02Q1940398,0,0,0,2929,0.0
V02Q1940509,0,0,0,7379,0.0
V02Q1940380,0,0,0,5208,0.0
V02Q1940363,0,0,0,7071,0.0
V02Q1940364,0,0,0,6820,0.0
V02Q1940367,0,0,0,7217,0.0
V02Q1940369,0,0,0,6612,0.0
V02Q1940370,0,0,0,6764,0.0
V02Q1940371,0,0,0,7230,0.0
V02Q1940372,0,0,0,7240,0.0
V02Q1940373,0,0,0,6651,0.0
V02Q1940374,0,0,0,6037,0.0
V02Q1940375,0,0,0,7380,0.0
V02Q1940376,0,0,0,4340,0.0
V02Q1940377,0,0,0,6851,0.0
V02Q1940378,0,0,0,7451,0.0
V02Q1940379,0,0,0,7340,0.0
V02Q1940381,0,0,0,7270,0.0
V02Q1940397,0,0,0,7167,0.0
V02Q1940382,0,0,0,7122,0.0
V02Q1940383,0,0,0,7349,0.0
V02Q1940385,0,0,0,7352,0.0
V02Q1940386,0,0,0,7472,0.0
V02Q1940387,0,0,0,7088,0.0
V02Q1940388,0,0,0,7181,0.0
V02Q1940389,0,0,0,7296,0.0
V02Q1940390,0,0,0,7262,0.0
V02Q1940391,0,0,0,7195,0.0
V02Q1940392,0,0,0,7311,0.0
V02Q1940393,0,0,0,7202,0.0
V02Q1940394,0,0,0,7430,0.0
V02Q1940395,0,0,0,7257,0.0
V02Q1940396,0,0,0,7384,0.0
V02Q1940434,0,0,0,6105,0.0
V02Q1940435,0,0,0,6822,0.0
V02Q1940438,0,0,0,6989,0.0
V02Q1940491,0,0,0,6807,0.0
V02Q1940477,0,0,0,5531,0.0
V02Q1940478,0,0,0,6752,0.0
V02Q1940479,0,0,0,6839,0.0
V02Q1940480,0,0,0,7444,0.0
V02Q1940481,0,0,0,5845,0.0
V02Q1940482,0,0,0,6724,0.0
V02Q1940483,0,0,0,6897,0.0
V02Q1940484,0,0,0,6915,0.0
V02Q1940485,0,0,0,2659,0.0
V02Q1940486,0,0,0,6836,0.0
V02Q1940487,0,0,0,6972,0.0
V02Q1940488,0,0,0,7321,0.0
V02Q1940489,0,0,0,7076,0.0
V02Q1940490,0,0,0,7370,0.0
V02Q1940492,0,0,0,7380,0.0
V02Q1940439,0,0,0,7167,0.0
V02Q1940493,0,0,0,7011,0.0
V02Q1940494,0,0,0,6318,0.0
V02Q1940621,0,0,0,7477,0.0
V02Q1940496,0,0,0,7327,0.0
V02Q1940497,0,0,0,6262,0.0
V02Q1940498,0,0,0,7442,0.0
V02Q1940499,0,0,0,6699,0.0
V02Q1940500,0,0,0,7446,0.0
V02Q1940501,0,0,0,6437,0.0
V02Q1940502,0,0,0,7321,0.0
V02Q1940503,0,0,0,7349,0.0
V02Q1940504,0,0,0,7275,0.0
V02Q1940507,0,0,0,6792,0.0
V02Q1940508,0,0,0,7461,0.0
V02Q1940476,0,0,0,6765,0.0
V02Q1940475,0,0,0,6648,0.0
V02Q1940474,0,0,0,6026,0.0
V02Q1940472,0,0,0,7456,0.0
V02Q1940440,0,0,0,7118,0.0
V02Q1940441,0,0,0,7327,0.0
V02Q1940442,0,0,0,5451,0.0
V02Q1940443,0,0,0,7148,0.0
V02Q1940445,0,0,0,7112,0.0
V02Q1940446,0,0,0,7175,0.0
V02Q1940448,0,0,0,7389,0.0
V02Q1940449,0,0,0,7365,0.0
V02Q1940450,0,0,0,7398,0.0
V02Q1940451,0,0,0,7313,0.0
V02Q1940452,0,0,0,7114,0.0
V02Q1940453,0,0,0,7011,0.0
V02Q1940454,0,0,0,7292,0.0
V02Q1940455,0,0,0,7310,0.0
V02Q1940456,0,0,0,7115,0.0
V02Q1940457,0,0,0,6177,0.0
V02Q1940458,0,0,0,6980,0.0
V02Q1940459,0,0,0,5644,0.0
V02Q1940461,0,0,0,7228,0.0
V02Q1940462,0,0,0,7131,0.0
V02Q1940463,0,0,0,7256,0.0
V02Q1940464,0,0,0,7378,0.0
V02Q1940465,0,0,0,7041,0.0
V02Q1940466,0,0,0,6966,0.0
V02Q1940467,0,0,0,7266,0.0
V02Q1940468,0,0,0,7102,0.0
V02Q1940469,0,0,0,7315,0.0
V02Q1940470,0,0,0,6201,0.0
V02Q1940471,0,0,0,7128,0.0
V02Q1940620,0,0,0,7393,0.0
V02Q1940639,0,0,0,7198,0.0
V02Q1940622,0,0,0,7374,0.0
V02Q1940823,0,0,0,7273,0.0
V02Q1940809,0,0,0,7373,0.0
V02Q1940810,0,0,0,6620,0.0
V02Q1940811,0,0,0,7262,0.0
V02Q1940812,0,0,0,6039,0.0
V02Q1940813,0,0,0,6067,0.0
V02Q1940814,0,0,0,7315,0.0
V02Q1940815,0,0,0,5854,0.0
V02Q1940816,0,0,0,6105,0.0
V02Q1940817,0,0,0,6511,0.0
V02Q1940818,0,0,0,6647,0.0
V02Q1940819,0,0,0,7262,0.0
V02Q1940820,0,0,0,7413,0.0
V02Q1940821,0,0,0,7265,0.0
V02Q1940822,0,0,0,6623,0.0
V02Q1940825,0,0,0,6578,0.0
V02Q1940807,0,0,0,6633,0.0
V02Q1940826,0,0,0,6910,0.0
V02Q1940827,0,0,0,6598,0.0
V02Q1940828,0,0,0,7259,0.0
V02Q1940829,0,0,0,6062,0.0
V02Q1940830,0,0,0,5318,0.0
V02Q1940832,0,0,0,7448,0.0
V02Q1940833,0,0,0,5483,0.0
V02Q1940834,0,0,0,7317,0.0
V02Q1940835,0,0,0,7050,0.0
V02Q1940836,0,0,0,3868,0.0
V02Q1940837,0,0,0,5819,0.0
V02Q1940839,0,0,0,6599,0.0
V02Q1940840,0,0,0,6631,0.0
V02Q1940841,0,0,0,6712,0.0
V02Q1940808,0,0,0,6713,0.0
V02Q1940806,0,0,0,6546,0.0
V02Q1940623,0,0,0,7323,0.0
V02Q1940787,0,0,0,7333,0.0
V02Q1940773,0,0,0,7381,0.0
V02Q1940774,0,0,0,7421,0.0
V02Q1940775,0,0,0,7295,0.0
V02Q1940776,0,0,0,7430,0.0
V02Q1940777,0,0,0,6854,0.0
V02Q1940778,0,0,0,6746,0.0
V02Q1940779,0,0,0,6925,0.0
V02Q1940780,0,0,0,7366,0.0
V02Q1940781,0,0,0,7392,0.0
V02Q1940782,0,0,0,3748,0.0
V02Q1940783,0,0,0,7210,0.0
V02Q1940784,0,0,0,7389,0.0
V02Q1940785,0,0,0,7371,0.0
V02Q1940786,0,0,0,7268,0.0
V02Q1940789,0,0,0,6720,0.0
V02Q1940805,0,0,0,6686,0.0
V02Q1940790,0,0,0,7376,0.0
V02Q1940791,0,0,0,7267,0.0
V02Q1940792,0,0,0,7380,0.0
V02Q1940793,0,0,0,6725,0.0
V02Q1940794,0,0,0,6670,0.0
V02Q1940795,0,0,0,6769,0.0
V02Q1940797,0,0,0,6709,0.0
V02Q1940798,0,0,0,7278,0.0
V02Q1940799,0,0,0,7272,0.0
V02Q1940800,0,0,0,6631,0.0
V02Q1940801,0,0,0,7056,0.0
V02Q1940802,0,0,0,6700,0.0
V02Q1940803,0,0,0,5776,0.0
V02Q1940804,0,0,0,7400,0.0
V02Q1940842,0,0,0,7010,0.0
V02Q1940843,0,0,0,5780,0.0
V02Q1940844,0,0,0,6675,0.0
V02Q1940949,0,0,0,7307,0.0
V02Q1940883,0,0,0,4419,0.0
V02Q1940884,0,0,0,6495,0.0
V02Q1940885,0,0,0,7076,0.0
V02Q1940886,0,0,0,6704,0.0
V02Q1940887,0,0,0,7304,0.0
V02Q1940888,0,0,0,7328,0.0
V02Q1940889,0,0,0,7190,0.0
V02Q1940941,0,0,0,7289,0.0
V02Q1940942,0,0,0,7093,0.0
V02Q1940943,0,0,0,7278,0.0
V02Q1940944,0,0,0,7408,0.0
V02Q1940945,0,0,0,7298,0.0
V02Q1940947,0,0,0,6867,0.0
V02Q1940948,0,0,0,6654,0.0
V02Q1940950,0,0,0,7161,0.0
V02Q1940845,0,0,0,7397,0.0
V02Q1940951,0,0,0,6672,0.0
V02Q1940952,0,0,0,5921,0.0
V02Q1940953,0,0,0,7336,0.0
V02Q1940955,0,0,0,6824,0.0
V02Q1941000,0,0,0,7028,0.0
V02Q1941006,0,0,0,7472,0.0
V02Q1941013,0,0,0,6491,0.0
V02Q1941015,0,0,0,7331,0.0
V02Q2300001,0,0,0,1691,0.0
V02Q2300002,0,0,0,1707,0.0
V02Q2300003,0,0,0,309,0.0
V02Q2300004,0,0,0,319,0.0
V02Q2300005,0,0,0,381,0.0
V02Q2300006,0,0,0,381,0.0
V02Q1940882,0,0,0,7416,0.0
V02Q1940881,0,0,0,5979,0.0
V02Q1940879,0,0,0,7216,0.0
V02Q1940878,0,0,0,4888,0.0
V02Q1940846,0,0,0,7243,0.0
V02Q1940847,0,0,0,7311,0.0
V02Q1940848,0,0,0,6658,0.0
V02Q1940849,0,0,0,7278,0.0
V02Q1940850,0,0,0,7461,0.0
V02Q1940851,0,0,0,6709,0.0
V02Q1940854,0,0,0,7400,0.0
V02Q1940855,0,0,0,6435,0.0
V02Q1940857,0,0,0,6725,0.0
V02Q1940858,0,0,0,6898,0.0
V02Q1940859,0,0,0,6691,0.0
V02Q1940860,0,0,0,6994,0.0
V02Q1940861,0,0,0,7463,0.0
V02Q1940862,0,0,0,7336,0.0
V02Q1940863,0,0,0,7467,0.0
V02Q1940864,0,0,0,7424,0.0
V02Q1940865,0,0,0,6883,0.0
V02Q1940866,0,0,0,7292,0.0
V02Q1940867,0,0,0,7359,0.0
V02Q1940868,0,0,0,7313,0.0
V02Q1940869,0,0,0,7333,0.0
V02Q1940870,0,0,0,7294,0.0
V02Q1940871,0,0,0,7027,0.0
V02Q1940872,0,0,0,6704,0.0
V02Q1940873,0,0,0,6613,0.0
V02Q1940874,0,0,0,6709,0.0
V02Q1940875,0,0,0,6520,0.0
V02Q1940876,0,0,0,7382,0.0
V02Q1940877,0,0,0,6483,0.0
V02Q1940772,0,0,0,7372,0.0
V02Q1940771,0,0,0,7384,0.0
V02Q1940770,0,0,0,6726,0.0
V02Q1940675,0,0,0,7057,0.0
V02Q1940660,0,0,0,7082,0.0
V02Q1940661,0,0,0,6654,0.0
V02Q1940663,0,0,0,7163,0.0
V02Q1940664,0,0,0,7312,0.0
V02Q1940665,0,0,0,7288,0.0
V02Q1940666,0,0,0,7041,0.0
V02Q1940667,0,0,0,7014,0.0
V02Q1940668,0,0,0,7261,0.0
V02Q1940669,0,0,0,7050,0.0
V02Q1940670,0,0,0,7323,0.0
V02Q1940671,0,0,0,7127,0.0
V02Q1940672,0,0,0,7202,0.0
V02Q1940673,0,0,0,6935,0.0
V02Q1940674,0,0,0,7086,0.0
V02Q1940676,0,0,0,7121,0.0
V02Q1940696,0,0,0,7382,0.0
V02Q1940678,0,0,0,4241,0.0
V02Q1940679,0,0,0,7364,0.0
V02Q1940680,0,0,0,3912,0.0
V02Q1940681,0,0,0,4382,0.0
V02Q1940682,0,0,0,7071,0.0
V02Q1940683,0,0,0,7131,0.0
V02Q1940684,0,0,0,7331,0.0
V02Q1940685,0,0,0,6983,0.0
V02Q1940686,0,0,0,7316,0.0
V02Q1940687,0,0,0,6554,0.0
V02Q1940689,0,0,0,5112,0.0
V02Q1940692,0,0,0,7009,0.0
V02Q1940693,0,0,0,6806,0.0
V02Q1940694,0,0,0,7216,0.0
V02Q1940659,0,0,0,6444,0.0
V02Q1940657,0,0,0,6591,0.0
V02Q1940656,0,0,0,6774,0.0
V02Q1940655,0,0,0,7036,0.0
V02Q1940624,0,0,0,6593,0.0
V02Q1940625,0,0,0,7116,0.0
V02Q1940626,0,0,0,7395,0.0
V02Q1940627,0,0,0,7139,0.0
V02Q1940628,0,0,0,4534,0.0
V02Q1940629,0,0,0,7345,0.0
V02Q1940630,0,0,0,6590,0.0
V02Q1940631,0,0,0,7328,0.0
V02Q1940633,0,0,0,7007,0.0
V02Q1940634,0,0,0,7424,0.0
V02Q1940635,0,0,0,6762,0.0
V02Q1940636,0,0,0,7253,0.0
V02Q1940637,0,0,0,7228,0.0
V02Q1940638,0,0,0,6897,0.0
V02Q1940360,0,0,0,6754,0.0
V02Q1940640,0,0,0,7255,0.0
V02Q1940641,0,0,0,6716,0.0
V02Q1940642,0,0,0,7257,0.0
V02Q1940643,0,0,0,6856,0.0
V02Q1940644,0,0,0,7055,0.0
V02Q1940645,0,0,0,61,0.0
V02Q1940646,0,0,0,7413,0.0
V02Q1940647,0,0,0,7362,0.0
V02Q1940648,0,0,0,6977,0.0
V02Q1940649,0,0,0,1258,0.0
V02Q1940650,0,0,0,7379,0.0
V02Q1940651,0,0,0,7279,0.0
V02Q1940652,0,0,0,6788,0.0
V02Q1940653,0,0,0,7374,0.0
V02Q1940695,0,0,0,6531,0.0
V02Q1940697,0,0,0,7257,0.0
V02Q1940769,0,0,0,7306,0.0
V02Q1940752,0,0,0,6224,0.0
V02Q1940737,0,0,0,7407,0.0
V02Q1940738,0,0,0,7235,0.0
V02Q1940739,0,0,0,7280,0.0
V02Q1940740,0,0,0,7101,0.0
V02Q1940741,0,0,0,7488,0.0
V02Q1940742,0,0,0,7386,0.0
V02Q1940743,0,0,0,7359,0.0
V02Q1940744,0,0,0,7303,0.0
V02Q1940745,0,0,0,6869,0.0
V02Q1940746,0,0,0,7427,0.0
V02Q1940747,0,0,0,7102,0.0
V02Q1940748,0,0,0,6986,0.0
V02Q1940749,0,0,0,7372,0.0
V02Q1940751,0,0,0,5304,0.0
V02Q1940753,0,0,0,7222,0.0
V02Q1940698,0,0,0,7287,0.0
V02Q1940754,0,0,0,7014,0.0
V02Q1940755,0,0,0,7098,0.0
V02Q1940757,0,0,0,7220,0.0
V02Q1940758,0,0,0,6386,0.0
V02Q1940759,0,0,0,6997,0.0
V02Q1940760,0,0,0,7089,0.0
V02Q1940761,0,0,0,7181,0.0
V02Q1940762,0,0,0,7405,0.0
V02Q1940763,0,0,0,7271,0.0
V02Q1940764,0,0,0,7364,0.0
V02Q1940765,0,0,0,7332,0.0
V02Q1940766,0,0,0,7069,0.0
V02Q1940767,0,0,0,7323,0.0
V02Q1940768,0,0,0,6863,0.0
V02Q1940736,0,0,0,7449,0.0
V02Q1940735,0,0,0,7346,0.0
V02Q1940734,0,0,0,5564,0.0
V02Q1940733,0,0,0,7197,0.0
V02Q1940699,0,0,0,6747,0.0
V02Q1940701,0,0,0,6937,0.0
V02Q1940702,0,0,0,6848,0.0
V02Q1940704,0,0,0,7152,0.0
V02Q1940705,0,0,0,7339,0.0
V02Q1940706,0,0,0,7395,0.0
V02Q1940707,0,0,0,6838,0.0
V02Q1940708,0,0,0,7348,0.0
V02Q1940709,0,0,0,7199,0.0
V02Q1940710,0,0,0,6598,0.0
V02Q1940711,0,0,0,7355,0.0
V02Q1940712,0,0,0,7473,0.0
V02Q1940713,0,0,0,6719,0.0
V02Q1940714,0,0,0,6952,0.0
V02Q1940715,0,0,0,6611,0.0
V02Q1940716,0,0,0,6733,0.0
V02Q1940717,0,0,0,7338,0.0
V02Q1940718,0,0,0,6686,0.0
V02Q1940719,0,0,0,6694,0.0
V02Q1940720,0,0,0,6726,0.0
V02Q1940721,0,0,0,6050,0.0
V02Q1940723,0,0,0,7204,0.0
V02Q1940724,0,0,0,7006,0.0
V02Q1940725,0,0,0,5270,0.0
V02Q1940726,0,0,0,6000,0.0
V02Q1940727,0,0,0,7379,0.0
V02Q1940729,0,0,0,6278,0.0
V02Q1940730,0,0,0,6721,0.0
V02Q1940732,0,0,0,7381,0.0
V02Q1940361,0,0,0,7322,0.0
V02Q1940343,0,0,0,6750,0.0
V02Q1940359,0,0,0,6760,0.0
OC3CL200208,0,0,0,7049,0.0
OC3CL200192,0,0,0,6814,0.0
OC3CL200193,0,0,0,6776,0.0
OC3CL200194,0,0,0,6498,0.0
OC3CL200196,0,0,0,7374,0.0
OC3CL200197,0,0,0,7325,0.0
OC3CL200198,0,0,0,7335,0.0
OC3CL200199,0,0,0,7305,0.0
OC3CL200200,0,0,0,7313,0.0
OC3CL200201,0,0,0,6702,0.0
OC3CL200202,0,0,0,7473,0.0
OC3CL200203,0,0,0,7466,0.0
OC3CL200204,0,0,0,6651,0.0
OC3CL200206,0,0,0,7177,0.0
OC3CL200207,0,0,0,7438,0.0
OC3CL200209,0,0,0,6755,0.0
OC3CL200190,0,0,0,6982,0.0
OC3CL200211,0,0,0,6650,0.0
OC3CL200212,0,0,0,7446,0.0
OC3CL200213,0,0,0,7241,0.0
OC3CL200214,0,0,0,7433,0.0
OC3CL200215,0,0,0,6668,0.0
OC3CL200216,0,0,0,7297,0.0
OC3CL200217,0,0,0,7341,0.0
OC3CL200218,0,0,0,7309,0.0
OC3CL200219,0,0,0,6688,0.0
OC3CL200220,0,0,0,6666,0.0
OC3CL200221,0,0,0,7244,0.0
OC3CL200222,0,0,0,7321,0.0
OC3CL200223,0,0,0,7277,0.0
OC3CL200224,0,0,0,7274,0.0
OC3CL200191,0,0,0,6818,0.0
OC3CL200189,0,0,0,6950,0.0
OC3CL200228,0,0,0,7390,0.0
OC3CL200172,0,0,0,7057,0.0
OC3CL200157,0,0,0,7117,0.0
OC3CL200158,0,0,0,7329,0.0
OC3CL200159,0,0,0,6789,0.0
OC3CL200160,0,0,0,7269,0.0
OC3CL200161,0,0,0,6931,0.0
OC3CL200162,0,0,0,5909,0.0
OC3CL200163,0,0,0,7293,0.0
OC3CL200164,0,0,0,7296,0.0
OC3CL200165,0,0,0,7264,0.0
OC3CL200166,0,0,0,7475,0.0
OC3CL200167,0,0,0,7472,0.0
OC3CL200169,0,0,0,7438,0.0
OC3CL200170,0,0,0,7221,0.0
OC3CL200171,0,0,0,7304,0.0
OC3CL200173,0,0,0,6958,0.0
OC3CL200188,0,0,0,6950,0.0
OC3CL200174,0,0,0,7443,0.0
OC3CL200175,0,0,0,7244,0.0
OC3CL200176,0,0,0,7300,0.0
OC3CL200177,0,0,0,7042,0.0
OC3CL200178,0,0,0,6955,0.0
OC3CL200179,0,0,0,7051,0.0
OC3CL200180,0,0,0,7014,0.0
OC3CL200181,0,0,0,7044,0.0
OC3CL200182,0,0,0,7037,0.0
OC3CL200183,0,0,0,7078,0.0
OC3CL200184,0,0,0,7073,0.0
OC3CL200185,0,0,0,7076,0.0
OC3CL200186,0,0,0,7009,0.0
OC3CL200187,0,0,0,7072,0.0
OC3CL200227,0,0,0,7272,0.0
OC3CL200229,0,0,0,7383,0.0
V02Q1940054,0,0,0,7331,0.0
OC3DL220002,0,0,0,35,0.0
OC3CL210109,0,0,0,6891,0.0
OC3CL210110,0,0,0,6961,0.0
OC3CL210111,0,0,0,6879,0.0
OC3CL210112,0,0,0,7016,0.0
OC3CL210113,0,0,0,6944,0.0
OC3CL210114,0,0,0,6990,0.0
OC3CL210115,0,0,0,6944,0.0
OC3CL210300,0,0,0,4452,0.0
OC3DL220000,0,0,0,21123,0.0
OC3DL220001,0,0,0,31869,0.0
OC3DL2200016,0,0,0,23,0.0
OC3DL2200017,0,0,0,23,0.0
OC3DL2200018,0,0,0,23,0.0
OC3DL2200019,0,0,0,23,0.0
OC3DL220020,0,0,0,1377,0.0
OC3CL210105,0,0,0,6784,0.0
OC3DL220021,0,0,0,1375,0.0
OC3DL220022,0,0,0,1180,0.0
OC3DL230025,0,0,0,737,0.0
OC3DL230026,0,0,0,737,0.0
OC3DL230027,0,0,0,738,0.0
V02Q1940043,0,0,0,6136,0.0
V02Q1940044,0,0,0,7313,0.0
V02Q1940045,0,0,0,6480,0.0
V02Q1940046,0,0,0,6497,0.0
V02Q1940047,0,0,0,7240,0.0
V02Q1940049,0,0,0,6931,0.0
V02Q1940050,0,0,0,7310,0.0
V02Q1940051,0,0,0,7285,0.0
V02Q1940052,0,0,0,7356,0.0
OC3CL210107,0,0,0,6860,0.0
OC3CL210104,0,0,0,6949,0.0
OC3CL200230,0,0,0,4976,0.0
OC3CL200246,0,0,0,6086,0.0
OC3CL200231,0,0,0,6054,0.0
OC3CL200233,0,0,0,6129,0.0
OC3CL200234,0,0,0,6152,0.0
OC3CL200235,0,0,0,5409,0.0
OC3CL200236,0,0,0,5523,0.0
OC3CL200237,0,0,0,5760,0.0
OC3CL200238,0,0,0,6125,0.0
OC3CL200239,0,0,0,5969,0.0
OC3CL200240,0,0,0,5971,0.0
OC3CL200241,0,0,0,6089,0.0
OC3CL200242,0,0,0,6117,0.0
OC3CL200243,0,0,0,6148,0.0
OC3CL200244,0,0,0,7210,0.0
OC3CL200245,0,0,0,7392,0.0
OC3CL200247,0,0,0,5826,0.0
OC3CL210103,0,0,0,6765,0.0
OC3CL200248,0,0,0,5682,0.0
OC3CL200249,0,0,0,5865,0.0
OC3CL200250,0,0,0,5692,0.0
OC3CL200251,0,0,0,6018,0.0
OC3CL200252,0,0,0,6129,0.0
OC3CL200253,0,0,0,6066,0.0
OC3CL200255,0,0,0,5983,0.0
OC3CL200256,0,0,0,6155,0.0
OC3CL200257,0,0,0,6107,0.0
OC3CL200258,0,0,0,19,0.0
OC3CL200259,0,0,0,6159,0.0
OC3CL210099,0,0,0,6811,0.0
OC3CL210101,0,0,0,6762,0.0
OC3CL210102,0,0,0,7003,0.0
OC3CL200155,0,0,0,7243,0.0
OC3CL200154,0,0,0,4799,0.0
OC3CL200152,0,0,0,5585,0.0
OC3CL200065,0,0,0,7273,0.0
OC3CL200050,0,0,0,6548,0.0
OC3CL200051,0,0,0,6910,0.0
OC3CL200052,0,0,0,6946,0.0
OC3CL200053,0,0,0,7022,0.0
OC3CL200054,0,0,0,7314,0.0
OC3CL200055,0,0,0,7260,0.0
OC3CL200056,0,0,0,7228,0.0
OC3CL200057,0,0,0,6918,0.0
OC3CL200058,0,0,0,7288,0.0
OC3CL200059,0,0,0,7498,0.0
OC3CL200060,0,0,0,7290,0.0
OC3CL200061,0,0,0,7182,0.0
OC3CL200063,0,0,0,7012,0.0
OC3CL200064,0,0,0,6318,0.0
OC3CL200066,0,0,0,7191,0.0
OC3CL200048,0,0,0,6993,0.0
OC3CL200067,0,0,0,7037,0.0
OC3CL200068,0,0,0,7348,0.0
OC3CL200069,0,0,0,6807,0.0
OC3CL200070,0,0,0,7359,0.0
OC3CL200071,0,0,0,7402,0.0
OC3CL200073,0,0,0,6961,0.0
OC3CL200074,0,0,0,6803,0.0
OC3CL200075,0,0,0,7446,0.0
OC3CL200076,0,0,0,7173,0.0
OC3CL200077,0,0,0,7434,0.0
OC3CL200078,0,0,0,7350,0.0
OC3CL200079,0,0,0,7065,0.0
OC3CL200080,0,0,0,6882,0.0
OC3CL200081,0,0,0,7363,0.0
OC3CL200049,0,0,0,6935,0.0
OC3CL200047,0,0,0,7436,0.0
OC3CL200151,0,0,0,6149,0.0
OC3CL200029,0,0,0,6970,0.0
OC3CL200010,0,0,0,7211,0.0
OC3CL200012,0,0,0,6768,0.0
OC3CL200013,0,0,0,6215,0.0
OC3CL200016,0,0,0,7271,0.0
OC3CL200018,0,0,0,7294,0.0
OC3CL200019,0,0,0,6873,0.0
OC3CL200020,0,0,0,7349,0.0
OC3CL200021,0,0,0,7395,0.0
OC3CL200022,0,0,0,7393,0.0
OC3CL200023,0,0,0,7378,0.0
OC3CL200025,0,0,0,7060,0.0
OC3CL200026,0,0,0,7069,0.0
OC3CL200027,0,0,0,7122,0.0
OC3CL200028,0,0,0,6950,0.0
OC3CL200030,0,0,0,6942,0.0
OC3CL200046,0,0,0,7104,0.0
OC3CL200031,0,0,0,7404,0.0
OC3CL200032,0,0,0,7273,0.0
OC3CL200033,0,0,0,7387,0.0
OC3CL200034,0,0,0,7465,0.0
OC3CL200035,0,0,0,6797,0.0
OC3CL200036,0,0,0,5379,0.0
OC3CL200037,0,0,0,6702,0.0
OC3CL200038,0,0,0,6472,0.0
OC3CL200040,0,0,0,5316,0.0
OC3CL200041,0,0,0,7272,0.0
OC3CL200042,0,0,0,7333,0.0
OC3CL200043,0,0,0,7440,0.0
OC3CL200044,0,0,0,7390,0.0
OC3CL200045,0,0,0,7007,0.0
OC3CL200082,0,0,0,7072,0.0
OC3CL200083,0,0,0,7358,0.0
OC3CL200084,0,0,0,7342,0.0
OC3CL200135,0,0,0,6059,0.0
OC3CL200119,0,0,0,7395,0.0
OC3CL200120,0,0,0,7356,0.0
OC3CL200121,0,0,0,6981,0.0
OC3CL200122,0,0,0,6943,0.0
OC3CL200123,0,0,0,7284,0.0
OC3CL200124,0,0,0,6964,0.0
OC3CL200125,0,0,0,6990,0.0
OC3CL200127,0,0,0,7428,0.0
OC3CL200128,0,0,0,6970,0.0
OC3CL200129,0,0,0,6676,0.0
OC3CL200130,0,0,0,7377,0.0
OC3CL200132,0,0,0,7395,0.0
OC3CL200133,0,0,0,7407,0.0
OC3CL200134,0,0,0,7397,0.0
OC3CL200136,0,0,0,6035,0.0
OC3CL200085,0,0,0,7384,0.0
OC3CL200137,0,0,0,5808,0.0
OC3CL200138,0,0,0,6153,0.0
OC3CL200139,0,0,0,6207,0.0
OC3CL200140,0,0,0,5982,0.0
OC3CL200141,0,0,0,6072,0.0
OC3CL200142,0,0,0,4759,0.0
OC3CL200143,0,0,0,4873,0.0
OC3CL200144,0,0,0,5618,0.0
OC3CL200145,0,0,0,5761,0.0
OC3CL200146,0,0,0,6155,0.0
OC3CL200147,0,0,0,6212,0.0
OC3CL200148,0,0,0,6200,0.0
OC3CL200149,0,0,0,6182,0.0
OC3CL200150,0,0,0,6151,0.0
OC3CL200118,0,0,0,7295,0.0
OC3CL200117,0,0,0,6938,0.0
OC3CL200116,0,0,0,7364,0.0
OC3CL200115,0,0,0,6706,0.0
OC3CL200086,0,0,0,4999,0.0
OC3CL200087,0,0,0,4813,0.0
OC3CL200088,0,0,0,4743,0.0
OC3CL200089,0,0,0,4721,0.0
OC3CL200090,0,0,0,4959,0.0
OC3CL200091,0,0,0,7279,0.0
OC3CL200092,0,0,0,6861,0.0
OC3CL200093,0,0,0,7298,0.0
OC3CL200094,0,0,0,6782,0.0
OC3CL200095,0,0,0,7337,0.0
OC3CL200096,0,0,0,7359,0.0
OC3CL200097,0,0,0,7289,0.0
OC3CL200098,0,0,0,7302,0.0
OC3CL200099,0,0,0,6973,0.0
OC3CL200100,0,0,0,7394,0.0
OC3CL200101,0,0,0,7335,0.0
OC3CL200102,0,0,0,7293,0.0
OC3CL200103,0,0,0,7306,0.0
OC3CL200104,0,0,0,7369,0.0
OC3CL200105,0,0,0,7334,0.0
OC3CL200106,0,0,0,7373,0.0
OC3CL200107,0,0,0,7346,0.0
OC3CL200108,0,0,0,7307,0.0
OC3CL200109,0,0,0,7461,0.0
OC3CL200110,0,0,0,7355,0.0
OC3CL200111,0,0,0,7469,0.0
OC3CL200112,0,0,0,3651,0.0
OC3CL200113,0,0,0,6925,0.0
OC3CL200114,0,0,0,7358,0.0
V02Q1940053,0,0,0,7369,0.0
V02Q1940056,0,0,0,6624,0.0
V02Q1940358,0,0,0,6872,0.0
V02Q1940268,0,0,0,7421,0.0
V02Q1940253,0,0,0,7281,0.0
V02Q1940254,0,0,0,7446,0.0
V02Q1940255,0,0,0,7492,0.0
V02Q1940256,0,0,0,7536,0.0
V02Q1940257,0,0,0,7239,0.0
V02Q1940258,0,0,0,7271,0.0
V02Q1940259,0,0,0,7420,0.0
V02Q1940260,0,0,0,7153,0.0
V02Q1940261,0,0,0,7308,0.0
V02Q1940263,0,0,0,7303,0.0
V02Q1940264,0,0,0,7230,0.0
V02Q1940265,0,0,0,7182,0.0
V02Q1940266,0,0,0,6882,0.0
V02Q1940267,0,0,0,6868,0.0
V02Q1940269,0,0,0,7012,0.0
V02Q1940251,0,0,0,7397,0.0
V02Q1940270,0,0,0,7294,0.0
V02Q1940271,0,0,0,7183,0.0
V02Q1940272,0,0,0,7082,0.0
V02Q1940273,0,0,0,7265,0.0
V02Q1940274,0,0,0,1506,0.0
V02Q1940275,0,0,0,5782,0.0
V02Q1940276,0,0,0,7234,0.0
V02Q1940277,0,0,0,6480,0.0
V02Q1940278,0,0,0,6899,0.0
V02Q1940280,0,0,0,7355,0.0
V02Q1940281,0,0,0,6799,0.0
V02Q1940282,0,0,0,7363,0.0
V02Q1940283,0,0,0,7132,0.0
V02Q1940284,0,0,0,5731,0.0
V02Q1940252,0,0,0,6623,0.0
V02Q1940250,0,0,0,6699,0.0
V02Q1940286,0,0,0,7317,0.0
V02Q1940232,0,0,0,6504,0.0
V02Q1940209,0,0,0,6018,0.0
V02Q1940210,0,0,0,6948,0.0
V02Q1940215,0,0,0,6824,0.0
V02Q1940216,0,0,0,6855,0.0
V02Q1940217,0,0,0,6574,0.0
V02Q1940218,0,0,0,6613,0.0
V02Q1940219,0,0,0,7350,0.0
V02Q1940220,0,0,0,6874,0.0
V02Q1940221,0,0,0,7359,0.0
V02Q1940222,0,0,0,7208,0.0
V02Q1940223,0,0,0,7323,0.0
V02Q1940224,0,0,0,6949,0.0
V02Q1940225,0,0,0,6506,0.0
V02Q1940231,0,0,0,7375,0.0
V02Q1940233,0,0,0,7310,0.0
V02Q1940249,0,0,0,7329,0.0
V02Q1940234,0,0,0,6499,0.0
V02Q1940235,0,0,0,7376,0.0
V02Q1940236,0,0,0,2093,0.0
V02Q1940237,0,0,0,6661,0.0
V02Q1940238,0,0,0,6996,0.0
V02Q1940240,0,0,0,7206,0.0
V02Q1940241,0,0,0,6557,0.0
V02Q1940242,0,0,0,7195,0.0
V02Q1940243,0,0,0,6767,0.0
V02Q1940244,0,0,0,7532,0.0
V02Q1940245,0,0,0,7099,0.0
V02Q1940246,0,0,0,7378,0.0
V02Q1940247,0,0,0,6826,0.0
V02Q1940248,0,0,0,6627,0.0
V02Q1940285,0,0,0,7318,0.0
V02Q1940287,0,0,0,7336,0.0
V02Q1940057,0,0,0,5640,0.0
V02Q1940340,0,0,0,7406,0.0
V02Q1940325,0,0,0,7207,0.0
V02Q1940326,0,0,0,6878,0.0
V02Q1940327,0,0,0,7319,0.0
V02Q1940328,0,0,0,7338,0.0
V02Q1940329,0,0,0,6689,0.0
V02Q1940330,0,0,0,7025,0.0
V02Q1940331,0,0,0,5965,0.0
V02Q1940333,0,0,0,6699,0.0
V02Q1940334,0,0,0,7229,0.0
V02Q1940335,0,0,0,7202,0.0
V02Q1940336,0,0,0,4291,0.0
V02Q1940337,0,0,0,6067,0.0
V02Q1940338,0,0,0,7212,0.0
V02Q1940339,0,0,0,5427,0.0
V02Q1940341,0,0,0,6694,0.0
V02Q1940323,0,0,0,7284,0.0
V02Q1940342,0,0,0,7191,0.0
OC3CL200009,0,0,0,3644,0.0
V02Q1940344,0,0,0,7290,0.0
V02Q1940345,0,0,0,6842,0.0
V02Q1940346,0,0,0,7034,0.0
V02Q1940347,0,0,0,6747,0.0
V02Q1940348,0,0,0,7370,0.0
V02Q1940349,0,0,0,6651,0.0
V02Q1940350,0,0,0,6776,0.0
V02Q1940351,0,0,0,7282,0.0
V02Q1940353,0,0,0,6246,0.0
V02Q1940354,0,0,0,6791,0.0
V02Q1940355,0,0,0,6697,0.0
V02Q1940356,0,0,0,7332,0.0
V02Q1940324,0,0,0,7166,0.0
V02Q1940322,0,0,0,7394,0.0
V02Q1940288,0,0,0,7427,0.0
V02Q1940303,0,0,0,7275,0.0
V02Q1940289,0,0,0,7254,0.0
V02Q1940290,0,0,0,6805,0.0
V02Q1940291,0,0,0,6863,0.0
V02Q1940292,0,0,0,6909,0.0
V02Q1940293,0,0,0,7359,0.0
V02Q1940294,0,0,0,7361,0.0
V02Q1940295,0,0,0,7152,0.0
V02Q1940296,0,0,0,7356,0.0
V02Q1940297,0,0,0,7043,0.0
V02Q1940298,0,0,0,6411,0.0
V02Q1940299,0,0,0,6907,0.0
V02Q1940300,0,0,0,7450,0.0
V02Q1940301,0,0,0,7304,0.0
V02Q1940302,0,0,0,5421,0.0
V02Q1940304,0,0,0,5573,0.0
V02Q1940321,0,0,0,6779,0.0
V02Q1940305,0,0,0,7335,0.0
V02Q1940306,0,0,0,6738,0.0
V02Q1940307,0,0,0,6915,0.0
V02Q1940308,0,0,0,7349,0.0
V02Q1940309,0,0,0,6616,0.0
V02Q1940310,0,0,0,7418,0.0
V02Q1940313,0,0,0,7264,0.0
V02Q1940314,0,0,0,7431,0.0
V02Q1940315,0,0,0,5909,0.0
V02Q1940316,0,0,0,6110,0.0
V02Q1940317,0,0,0,6717,0.0
V02Q1940318,0,0,0,663,0.0
V02Q1940319,0,0,0,7341,0.0
V02Q1940320,0,0,0,7242,0.0
V02Q1940208,0,0,0,6841,0.0
V02Q1940207,0,0,0,7406,0.0
V02Q1940206,0,0,0,7327,0.0
V02Q1940114,0,0,0,7414,0.0
V02Q1940100,0,0,0,7365,0.0
V02Q1940101,0,0,0,7230,0.0
V02Q1940102,0,0,0,7278,0.0
V02Q1940103,0,0,0,6875,0.0
V02Q1940104,0,0,0,7353,0.0
V02Q1940105,0,0,0,7260,0.0
V02Q1940106,0,0,0,7364,0.0
V02Q1940107,0,0,0,7333,0.0
V02Q1940108,0,0,0,6742,0.0
V02Q1940109,0,0,0,7275,0.0
V02Q1940110,0,0,0,6243,0.0
V02Q1940111,0,0,0,6632,0.0
V02Q1940112,0,0,0,7306,0.0
V02Q1940113,0,0,0,7308,0.0
V02Q1940115,0,0,0,6917,0.0
V02Q1940098,0,0,0,5433,0.0
V02Q1940116,0,0,0,6915,0.0
V02Q1940117,0,0,0,7287,0.0
V02Q1940118,0,0,0,7390,0.0
V02Q1940119,0,0,0,4174,0.0
V02Q1940120,0,0,0,7350,0.0
V02Q1940121,0,0,0,5820,0.0
V02Q1940122,0,0,0,7133,0.0
V02Q1940123,0,0,0,7413,0.0
V02Q1940125,0,0,0,4321,0.0
V02Q1940127,0,0,0,7385,0.0
V02Q1940128,0,0,0,6900,0.0
V02Q1940131,0,0,0,6809,0.0
V02Q1940132,0,0,0,6908,0.0
V02Q1940133,0,0,0,6778,0.0
V02Q1940099,0,0,0,6684,0.0
V02Q1940097,0,0,0,6940,0.0
V02Q1940205,0,0,0,7172,0.0
V02Q1940074,0,0,0,5038,0.0
V02Q1940058,0,0,0,7395,0.0
V02Q1940060,0,0,0,7384,0.0
V02Q1940061,0,0,0,6200,0.0
V02Q1940062,0,0,0,7347,0.0
V02Q1940063,0,0,0,7419,0.0
V02Q1940064,0,0,0,7360,0.0
V02Q1940065,0,0,0,7342,0.0
V02Q1940066,0,0,0,7374,0.0
V02Q1940067,0,0,0,4391,0.0
V02Q1940069,0,0,0,7306,0.0
V02Q1940070,0,0,0,7348,0.0
V02Q1940071,0,0,0,5783,0.0
V02Q1940072,0,0,0,7025,0.0
V02Q1940073,0,0,0,7176,0.0
V02Q1940075,0,0,0,6328,0.0
V02Q1940096,0,0,0,6771,0.0
V02Q1940076,0,0,0,7197,0.0
V02Q1940077,0,0,0,7519,0.0
V02Q1940081,0,0,0,7108,0.0
V02Q1940082,0,0,0,7330,0.0
V02Q1940083,0,0,0,7312,0.0
V02Q1940084,0,0,0,7353,0.0
V02Q1940085,0,0,0,7258,0.0
V02Q1940086,0,0,0,7340,0.0
V02Q1940088,0,0,0,7030,0.0
V02Q1940089,0,0,0,7292,0.0
V02Q1940091,0,0,0,7132,0.0
V02Q1940092,0,0,0,7026,0.0
V02Q1940094,0,0,0,6817,0.0
V02Q1940095,0,0,0,6118,0.0
V02Q1940134,0,0,0,6878,0.0
V02Q1940135,0,0,0,7311,0.0
V02Q1940136,0,0,0,7361,0.0
V02Q1940188,0,0,0,7088,0.0
V02Q1940174,0,0,0,7486,0.0
V02Q1940175,0,0,0,7318,0.0
V02Q1940176,0,0,0,7166,0.0
V02Q1940177,0,0,0,7362,0.0
V02Q1940178,0,0,0,6446,0.0
V02Q1940179,0,0,0,7348,0.0
V02Q1940180,0,0,0,7392,0.0
V02Q1940181,0,0,0,6850,0.0
V02Q1940182,0,0,0,6970,0.0
V02Q1940183,0,0,0,6597,0.0
V02Q1940184,0,0,0,7522,0.0
V02Q1940185,0,0,0,7471,0.0
V02Q1940186,0,0,0,4753,0.0
V02Q1940187,0,0,0,7034,0.0
V02Q1940189,0,0,0,7319,0.0
V02Q1940137,0,0,0,7440,0.0
V02Q1940190,0,0,0,7361,0.0
V02Q1940191,0,0,0,6626,0.0
V02Q1940192,0,0,0,7356,0.0
V02Q1940193,0,0,0,7224,0.0
V02Q1940194,0,0,0,7311,0.0
V02Q1940195,0,0,0,6718,0.0
V02Q1940196,0,0,0,6858,0.0
V02Q1940197,0,0,0,6976,0.0
V02Q1940198,0,0,0,5128,0.0
V02Q1940199,0,0,0,7469,0.0
V02Q1940201,0,0,0,7442,0.0
V02Q1940202,0,0,0,7409,0.0
V02Q1940203,0,0,0,7300,0.0
V02Q1940204,0,0,0,7188,0.0
V02Q1940173,0,0,0,7307,0.0
V02Q1940172,0,0,0,7415,0.0
V02Q1940171,0,0,0,7448,0.0
V02Q1940170,0,0,0,7446,0.0
V02Q1940138,0,0,0,7423,0.0
V02Q1940139,0,0,0,6783,0.0
V02Q1940140,0,0,0,6809,0.0
V02Q1940141,0,0,0,7448,0.0
V02Q1940142,0,0,0,7351,0.0
V02Q1940143,0,0,0,7349,0.0
V02Q1940144,0,0,0,7403,0.0
V02Q1940145,0,0,0,7315,0.0
V02Q1940146,0,0,0,6401,0.0
V02Q1940147,0,0,0,7145,0.0
V02Q1940148,0,0,0,7447,0.0
V02Q1940149,0,0,0,6907,0.0
V02Q1940151,0,0,0,6669,0.0
V02Q1940152,0,0,0,7342,0.0
V02Q1940153,0,0,0,7081,0.0
V02Q1940154,0,0,0,6961,0.0
V02Q1940155,0,0,0,5778,0.0
V02Q1940156,0,0,0,6885,0.0
V02Q1940157,0,0,0,6492,0.0
V02Q1940159,0,0,0,6955,0.0
V02Q1940160,0,0,0,7294,0.0
V02Q1940161,0,0,0,6308,0.0
V02Q1940162,0,0,0,7328,0.0
V02Q1940163,0,0,0,7267,0.0
V02Q1940164,0,0,0,7344,0.0
V02Q1940166,0,0,0,7386,0.0
V02Q1940167,0,0,0,7293,0.0
V02Q1940168,0,0,0,7370,0.0
V02Q1940169,0,0,0,7351,0.0
V02Q2300007,0,0,0,381,0.0
